date,geography,geography code,Ethnic Total,White,Mixed,Asian,Black,Other,Economic Total,Economically active,Economically active: In employment,Economically active: Unemployed,Economically inactive
2011,Darlington,E06000005,105564,101595,1146,2205,357,261,76635,53443,47487,5956,23192
2011,County Durham,E06000047,513242,503769,3094,4856,701,822,383796,247101,219826,27275,136695
2011,Hartlepool,E06000001,92028,89899,550,1304,170,105,66804,43513,36532,6981,23291
2011,Middlesbrough,E06000002,138412,122055,2362,10768,1731,1496,100551,63582,51535,12047,36969
2011,Northumberland,E06000057,316028,311066,1692,2658,338,274,233224,158268,142811,15457,74956
2011,Redcar and Cleveland,E06000003,135177,133203,853,869,122,130,99177,63530,54558,8972,35647
2011,Stockton-on-Tees,E06000004,191610,181299,1997,6632,1133,549,140654,96259,83938,12321,44395
2011,Gateshead,E08000037,200214,192742,1558,3738,1081,1095,148079,100184,88817,11367,47895
2011,Newcastle upon Tyne,E08000021,280177,239533,4279,27107,5160,4098,212864,133848,108778,25070,79016
2011,North Tyneside,E08000022,200801,194025,1815,3815,734,412,147889,104242,92799,11443,43647
2011,South Tyneside,E08000023,148127,142099,1325,3311,420,972,108981,72645,62266,10379,36336
2011,Sunderland,E08000024,275506,264282,1778,7336,1273,837,205552,135467,116562,18905,70085
2011,Blackburn with Darwen,E06000008,147489,102009,1823,41494,933,1230,104417,67033,58129,8904,37384
2011,Blackpool,E06000009,142065,137339,1753,2282,346,345,103813,68540,59026,9514,35273
2011,Cheshire East,E06000049,370127,357940,3873,6060,1402,852,270953,191253,174859,16394,79700
2011,Cheshire West and Chester,E06000050,329608,321025,3050,4097,908,528,243155,170778,153704,17074,72377
2011,Halton,E06000006,125746,123041,1356,943,260,146,92708,63411,55741,7670,29297
2011,Warrington,E06000007,202228,193992,2144,4911,694,487,149461,107765,97274,10491,41696
2011,Allerdale,E07000026,96422,95385,426,477,73,61,70978,48904,44833,4071,22074
2011,Barrow-in-Furness,E07000027,69087,67940,360,633,70,84,51103,33897,30348,3549,17206
2011,Carlisle,E07000028,107524,105480,535,1248,147,114,79531,57210,51767,5443,22321
2011,Copeland,E07000029,70603,69491,339,629,84,60,52702,35335,32184,3151,17367
2011,Eden,E07000030,52564,51999,211,292,22,40,38735,28413,26527,1886,10322
2011,South Lakeland,E07000031,103658,101962,633,787,183,93,75831,53396,49980,3416,22435
2011,Bolton,E08000001,276786,226645,4892,38749,4652,1848,200723,134933,118777,16156,65790
2011,Bury,E08000002,185060,165032,3365,13407,1893,1363,134687,94680,85291,9389,40007
2011,Manchester,E08000003,503127,335109,23161,85986,43484,15387,382932,243224,194093,49131,139708
2011,Oldham,E08000004,224897,174326,4057,43165,2797,552,159765,106398,93015,13383,53367
2011,Rochdale,E08000005,211699,172874,3569,31630,2770,856,152742,101003,87821,13182,51739
2011,Salford,E08000006,233933,210862,4616,9429,6541,2485,173117,118130,101014,17116,54987
2011,Stockport,E08000007,283275,260819,5104,13762,1958,1632,205310,146296,132659,13637,59014
2011,Tameside,E08000008,219324,199429,3159,14553,1784,399,161459,111016,98945,12071,50443
2011,Trafford,E08000009,226578,193834,6031,17973,6540,2200,162806,118064,106854,11210,44742
2011,Wigan,E08000010,317849,309193,2756,3519,1678,703,236495,162781,145028,17753,73714
2011,Burnley,E07000117,87059,76054,976,9578,211,240,63376,41879,36907,4972,21497
2011,Chorley,E07000118,107155,103833,1016,1710,401,195,79951,56645,52009,4636,23306
2011,Fylde,E07000119,75757,73844,742,845,163,163,54544,36447,33285,3162,18097
2011,Hyndburn,E07000120,80734,70778,696,9007,106,147,58356,39118,34663,4455,19238
2011,Lancaster,E07000121,138375,132342,1356,3732,628,317,103296,67262,58498,8764,36034
2011,Pendle,E07000122,89452,71437,946,16807,126,136,64440,42765,37965,4800,21675
2011,Preston,E07000123,140202,112415,3326,21732,1676,1053,104085,70509,59350,11159,33576
2011,Ribble Valley,E07000124,57132,55904,360,729,92,47,41285,29672,27612,2060,11613
2011,Rossendale,E07000125,67982,63778,602,3396,123,83,50075,35186,31864,3322,14889
2011,South Ribble,E07000126,109057,105847,1174,1612,268,156,80458,58577,53816,4761,21881
2011,West Lancashire,E07000127,110685,108603,866,913,174,129,81601,55680,48969,6711,25921
2011,Wyre,E07000128,107749,105852,664,993,130,110,77663,51450,46576,4874,26213
2011,Knowsley,E08000011,145893,141858,1913,1403,505,214,106155,69617,59456,10161,36538
2011,Liverpool,E08000012,466415,414671,11756,19403,12308,8277,356876,226270,182270,44000,130606
2011,Sefton,E08000014,273790,266741,2820,2719,796,714,198197,133012,117085,15927,65185
2011,St. Helens,E08000013,175308,171877,1179,1764,248,240,129584,86121,76158,9963,43463
2011,Wirral,E08000015,319783,310156,3286,5116,695,530,230851,153240,135543,17697,77611
2011,East Riding of Yorkshire,E06000011,334179,327789,2301,2961,598,530,245594,168860,153451,15409,76734
2011,"Kingston upon Hull, City of",E06000010,256406,241321,3454,6471,2996,2164,190610,128130,105890,22240,62480
2011,North East Lincolnshire,E06000012,159616,155421,1186,2129,411,469,115823,79227,68609,10618,36596
2011,North Lincolnshire,E06000013,167446,160748,1244,4549,494,411,122329,84668,75915,8753,37661
2011,York,E06000014,198051,186731,2413,6740,1194,973,149789,104945,91847,13098,44844
2011,Craven,E07000163,55409,53964,375,970,61,39,40056,28744,26704,2040,11312
2011,Hambleton,E07000164,89140,87635,593,600,188,124,65255,47068,43959,3109,18187
2011,Harrogate,E07000165,157869,152075,1776,2409,1147,462,114038,84662,78711,5951,29376
2011,Richmondshire,E07000166,51965,49556,502,1247,496,164,38652,29017,27166,1851,9635
2011,Ryedale,E07000167,51751,51064,302,273,80,32,37581,26644,24785,1859,10937
2011,Scarborough,E07000168,108793,106104,869,1364,240,216,79393,52245,46482,5763,27148
2011,Selby,E07000169,83449,82077,626,493,212,41,61831,45720,41990,3730,16111
2011,Barnsley,E08000016,231221,226285,1630,1661,1221,424,170405,113306,100751,12555,57099
2011,Doncaster,E08000017,302402,288066,3321,7614,2337,1064,220877,147770,130306,17464,73107
2011,Rotherham,E08000018,257280,240758,2551,10551,2112,1308,187959,125899,111684,14215,62060
2011,Sheffield,E08000019,552698,462544,13289,44385,20082,12398,411004,270239,227822,42417,140765
2011,Bradford,E08000032,522452,352317,12979,140149,9267,7740,366217,243727,210013,33714,122490
2011,Calderdale,E08000033,203826,182787,2797,16875,899,468,148766,104893,93611,11282,43873
2011,Kirklees,E08000034,422458,334270,9790,67782,7905,2711,307194,209514,184331,25183,97680
2011,Leeds,E08000035,751485,639487,19632,58243,25893,8230,560849,389929,333333,56596,170920
2011,Wakefield,E08000036,325837,310957,2928,8498,2512,942,240997,164768,148026,16742,76229
2011,Derby,E06000015,248752,199751,7232,31095,7320,3354,179291,123691,106946,16745,55600
2011,Leicester,E06000016,329839,166636,11580,122470,20585,8568,242232,156425,128142,28283,85807
2011,Nottingham,E06000018,305680,218698,20265,40039,22185,4493,232072,142327,112861,29466,89745
2011,Rutland,E06000017,37369,36301,389,365,251,63,27052,18758,17509,1249,8294
2011,Amber Valley,E07000032,122309,120023,980,929,253,124,90558,63280,57786,5494,27278
2011,Bolsover,E07000033,75866,74452,518,612,267,17,55945,37442,33578,3864,18503
2011,Chesterfield,E07000034,103788,100172,1094,1592,782,148,76409,51909,46543,5366,24500
2011,Derbyshire Dales,E07000035,71116,70117,466,398,87,48,51978,36541,34001,2540,15437
2011,Erewash,E07000036,112081,108765,1269,1383,536,128,82609,59044,53309,5735,23565
2011,High Peak,E07000037,90892,88954,944,711,184,99,67389,48560,44173,4387,18829
2011,North East Derbyshire,E07000038,99023,97084,786,795,236,122,73460,49919,45568,4351,23541
2011,South Derbyshire,E07000039,94611,90527,1062,2375,425,222,69450,50358,46409,3949,19092
2011,Blaby,E07000129,93915,85451,1505,5718,900,341,68558,50661,46701,3960,17897
2011,Charnwood,E07000130,166100,145114,2577,16138,1327,944,124967,84609,75236,9373,40358
2011,Harborough,E07000131,85382,81316,971,2563,327,205,61913,45791,42742,3049,16122
2011,Hinckley and Bosworth,E07000132,105078,101369,1027,2246,262,174,77716,56538,52259,4279,21178
2011,Melton,E07000133,50376,49319,414,518,95,30,36955,27422,25358,2064,9533
2011,North West Leicestershire,E07000134,93468,91187,881,1074,205,121,68556,48999,44994,4005,19557
2011,Oadby and Wigston,E07000135,56170,41011,1176,12520,671,792,40797,28119,25226,2893,12678
2011,Boston,E07000136,64637,62592,664,928,278,175,47306,33031,30070,2961,14275
2011,East Lindsey,E07000137,136401,134314,937,789,264,97,99928,60716,54875,5841,39212
2011,Lincoln,E07000138,93541,89379,1230,1794,778,360,71577,49523,40981,8542,22054
2011,North Kesteven,E07000139,107766,105835,791,750,251,139,78616,55065,50921,4144,23551
2011,South Holland,E07000140,88270,86370,796,747,257,100,63920,44276,40532,3744,19644
2011,South Kesteven,E07000141,133788,130394,1142,1580,509,163,97319,70273,64499,5774,27046
2011,West Lindsey,E07000142,89250,87600,630,728,224,68,65531,44768,40734,4034,20763
2011,Corby,E07000150,61255,58519,836,782,1008,110,45049,33166,29686,3480,11883
2011,Daventry,E07000151,77843,75123,971,1183,481,85,57379,41546,38296,3250,15833
2011,East Northamptonshire,E07000152,86765,83842,1052,1096,630,145,63006,45821,42219,3602,17185
2011,Kettering,E07000153,93475,87740,1313,3023,991,408,67920,50012,45524,4488,17908
2011,Northampton,E07000154,212069,179238,6849,13751,10741,1490,155682,115479,101887,13592,40203
2011,South Northamptonshire,E07000155,85189,82572,1003,1129,376,109,62321,47449,44317,3132,14872
2011,Wellingborough,E07000156,75356,65788,2158,4463,2696,251,54817,39247,35256,3991,15570
2011,Ashfield,E07000170,119497,116733,1059,1099,472,134,88037,59970,53931,6039,28067
2011,Bassetlaw,E07000171,112863,109892,996,1255,520,200,83305,56556,51284,5272,26749
2011,Broxtowe,E07000172,109487,101538,1827,4503,933,686,81573,56838,51329,5509,24735
2011,Gedling,E07000173,113543,105656,2619,3343,1653,272,83284,59493,53867,5626,23791
2011,Mansfield,E07000174,104466,101522,1106,1289,398,151,77155,52392,46961,5431,24763
2011,Newark and Sherwood,E07000175,114817,111958,1160,1036,499,164,84145,57971,52872,5099,26174
2011,Rushcliffe,E07000176,111129,103504,1949,4614,627,435,80755,58045,53133,4912,22710
2011,"Herefordshire, County of",E06000019,183477,180169,1270,1439,331,268,133442,95114,87590,7524,38328
2011,Shropshire,E06000051,306129,299874,2168,3089,580,418,223892,158983,146401,12582,64909
2011,Stoke-on-Trent,E06000021,249008,220712,4491,18442,3741,1622,182808,119743,103269,16474,63065
2011,Telford and Wrekin,E06000020,166641,154415,2983,6991,1779,473,122279,84947,75685,9262,37332
2011,Cannock Chase,E07000192,97462,95256,867,982,280,77,72274,51306,46115,5191,20968
2011,East Staffordshire,E07000193,113583,102704,1619,7864,1023,373,83059,58578,53144,5434,24481
2011,Lichfield,E07000194,100654,97399,1034,1623,481,117,74757,51862,47536,4326,22895
2011,Newcastle-under-Lyme,E07000195,123871,117662,1490,3512,828,379,92335,61568,54599,6969,30767
2011,South Staffordshire,E07000196,108131,103700,1495,2122,578,236,80718,56418,51671,4747,24300
2011,Stafford,E07000197,130869,124308,1694,3288,1107,472,97297,68274,61923,6351,29023
2011,Staffordshire Moorlands,E07000198,97106,95825,602,502,120,57,72085,49988,46130,3858,22097
2011,Tamworth,E07000199,76813,74761,803,763,393,93,56833,41188,37120,4068,15645
2011,North Warwickshire,E07000218,62014,60709,506,580,172,47,46170,33151,30410,2741,13019
2011,Nuneaton and Bedworth,E07000219,125252,114392,1396,7880,1047,537,92090,65173,58292,6881,26917
2011,Rugby,E07000220,100075,90565,1986,5225,1987,312,72759,53457,49018,4439,19302
2011,Stratford-on-Avon,E07000221,120485,117307,1258,1466,264,190,87728,63253,58844,4409,24475
2011,Warwick,E07000222,137648,122715,2803,9945,973,1212,102883,73309,66564,6745,29574
2011,Birmingham,E08000025,1073045,621636,47605,285640,96360,21804,760252,488221,400679,87542,272031
2011,Coventry,E08000026,316960,234029,8230,51598,17764,5339,231871,153745,128764,24981,78126
2011,Dudley,E08000027,312925,281607,5758,18942,4671,1947,226726,155530,137720,17810,71196
2011,Sandwell,E08000028,308063,215471,10199,59258,18357,4778,219508,146653,124338,22315,72855
2011,Solihull,E08000029,206674,184244,4404,13561,3239,1226,148360,105108,94586,10522,43252
2011,Walsall,E08000030,269323,212469,7224,41022,6369,2239,191974,126805,108668,18137,65169
2011,Wolverhampton,E08000031,249470,169682,12784,44960,17309,4735,179983,120402,99729,20673,59581
2011,Bromsgrove,E07000234,93637,89696,1396,1925,444,176,67807,48664,44867,3797,19143
2011,Malvern Hills,E07000235,74631,72841,639,902,151,98,53512,36261,33349,2912,17251
2011,Redditch,E07000236,84214,77497,1655,4029,862,171,62523,46220,41464,4756,16303
2011,Worcester,E07000237,98768,92294,1395,4366,473,240,73382,53966,47532,6434,19416
2011,Wychavon,E07000238,116944,114457,962,1129,228,168,85481,61260,56459,4801,24221
2011,Wyre Forest,E07000239,97975,95273,998,1390,214,100,72331,49712,45060,4652,22619
2011,Bedford,E06000055,157479,126846,5386,17932,6202,1113,113764,81782,72610,9172,31982
2011,Central Bedfordshire,E06000056,254381,238722,4789,6402,3614,854,186658,139525,127845,11680,47133
2011,Luton,E06000032,203201,111079,8281,60952,19909,2980,145208,100272,83876,16396,44936
2011,Peterborough,E06000031,183631,151544,4948,21492,4164,1483,132318,95646,85370,10276,36672
2011,Southend-on-Sea,E06000033,173658,159023,3651,6440,3647,897,125007,88324,78722,9602,36683
2011,Thurrock,E06000034,157705,135429,3099,5927,12323,927,114124,84464,75151,9313,29660
2011,Cambridge,E07000008,123867,102205,3944,13618,2097,2003,98283,62886,54642,8244,35397
2011,East Cambridgeshire,E07000009,83818,80673,1182,1215,506,242,60714,45920,42764,3156,14794
2011,Fenland,E07000010,95262,92631,901,1075,497,158,69258,47829,43413,4416,21429
2011,Huntingdonshire,E07000011,169508,160691,2530,4190,1642,455,125346,93481,86207,7274,31865
2011,South Cambridgeshire,E07000012,148755,138787,2524,5540,1268,636,107779,82079,76608,5471,25700
2011,Basildon,E07000066,174497,161677,2887,4766,4685,482,125795,89570,80665,8905,36225
2011,Braintree,E07000067,147084,142087,1837,1998,913,249,106718,78715,72016,6699,28003
2011,Brentwood,E07000068,73601,68868,1196,2350,896,291,52959,38149,35283,2866,14810
2011,Castle Point,E07000069,88011,85273,911,1012,661,154,64626,44080,40222,3858,20546
2011,Chelmsford,E07000070,168310,157983,2646,4962,2051,668,123693,91339,83355,7984,32354
2011,Colchester,E07000071,173074,159306,3152,6355,2575,1686,128562,91385,81214,10171,37177
2011,Epping Forest,E07000072,124659,112869,2649,5922,2404,815,90622,65304,59936,5368,25318
2011,Harlow,E07000073,81944,72999,1752,3733,3090,370,58669,43847,39010,4837,14822
2011,Maldon,E07000074,61629,60429,506,484,150,60,45406,31856,29513,2343,13550
2011,Rochford,E07000075,83287,80937,905,881,433,131,60425,42804,39503,3301,17621
2011,Tendring,E07000076,138048,134667,1467,1275,434,205,97050,59908,53285,6623,37142
2011,Uttlesford,E07000077,79443,76761,977,1122,417,166,57086,42473,39603,2870,14613
2011,Broxbourne,E07000095,93609,84530,2141,2190,3957,791,67599,49426,44754,4672,18173
2011,Dacorum,E07000096,144847,131537,3075,6770,2990,475,104410,77800,71048,6752,26610
2011,East Hertfordshire,E07000242,137687,131456,2214,2681,984,352,100093,75434,70178,5256,24659
2011,Hertsmere,E07000098,100031,85063,2619,7393,3927,1029,71511,52435,47789,4646,19076
2011,North Hertfordshire,E07000099,127114,113755,3376,6821,2491,671,91510,68564,62969,5595,22946
2011,St Albans,E07000240,140664,124380,3904,9011,2388,981,99863,74553,69041,5512,25310
2011,Stevenage,E07000243,83957,73598,2265,4848,2836,410,60988,46140,41034,5106,14848
2011,Three Rivers,E07000102,87317,75294,2002,7993,1610,418,62440,46280,42662,3618,16160
2011,Watford,E07000103,90301,64946,3104,16170,5229,852,66285,50770,45809,4961,15515
2011,Welwyn Hatfield,E07000241,110535,92936,2797,8704,4989,1109,81514,57036,48850,8186,24478
2011,Breckland,E07000143,130491,127116,1562,1040,596,177,94176,65029,59621,5408,29147
2011,Broadland,E07000144,124646,121795,1064,1265,331,191,90305,64232,59597,4635,26073
2011,Great Yarmouth,E07000145,97277,94215,1159,1204,439,260,70234,46018,40055,5963,24216
2011,King's Lynn and West Norfolk,E07000146,147451,143409,1372,1863,561,246,106591,71704,65459,6245,34887
2011,North Norfolk,E07000147,101499,100127,617,531,157,67,72453,45819,42147,3672,26634
2011,Norwich,E07000148,132512,120375,3039,5844,2147,1107,100702,68772,58247,10525,31930
2011,South Norfolk,E07000149,124012,120981,1214,1270,378,169,89337,63158,58512,4646,26179
2011,Babergh,E07000200,87740,85845,827,666,264,138,63075,44347,41035,3312,18728
2011,Forest Heath,E07000201,59748,54907,1744,1263,1296,538,44053,33115,30717,2398,10938
2011,Ipswich,E07000202,133384,118596,4816,5740,3096,1136,97167,71423,63192,8231,25744
2011,Mid Suffolk,E07000203,96731,94667,953,647,371,93,70073,50607,47096,3511,19466
2011,St Edmundsbury,E07000204,111008,106615,1404,1824,902,263,80968,59324,54760,4564,21644
2011,Suffolk Coastal,E07000205,124298,119976,1513,2032,556,221,88250,61006,56467,4539,27244
2011,Waveney,E07000206,115254,112589,1215,959,369,122,81877,53460,47714,5746,28417
2011,Camden,E09000007,220338,146055,12322,35446,18060,8455,173833,118397,103986,14411,55436
2011,City of London,E09000001,7375,5799,289,940,193,154,6307,4972,4641,331,1335
2011,Hackney,E09000012,246270,134617,15869,25867,56858,13059,187423,133883,113367,20516,53540
2011,Hammersmith and Fulham,E09000013,182493,124222,10044,16635,21505,10087,145552,107754,95640,12114,37798
2011,Haringey,E09000014,254926,154343,16548,24150,47830,12055,193062,138189,118886,19303,54873
2011,Islington,E09000019,206125,140515,13339,19034,26294,6943,165149,117488,102325,15163,47661
2011,Kensington and Chelsea,E09000020,158649,112017,8986,15861,10333,11452,126080,87517,79198,8319,38563
2011,Lambeth,E09000022,303086,173025,23160,20938,78542,7421,237730,183190,159823,23367,54540
2011,Lewisham,E09000023,275885,147686,20472,25534,74942,7251,206255,151793,128905,22888,54462
2011,Newham,E09000025,307984,89216,13945,133895,60256,10672,228958,153761,118862,34899,75197
2011,Southwark,E09000028,288283,156349,17778,27192,77511,9453,224551,163859,139286,24573,60692
2011,Tower Hamlets,E09000030,254096,114819,10360,104501,18629,5787,196552,137233,113219,24014,59319
2011,Wandsworth,E09000032,306995,219216,15241,33338,32756,6444,243533,189789,172468,17321,53744
2011,Westminster,E09000033,219396,135330,11395,31862,16472,24337,175505,120418,107531,12887,55087
2011,Barking and Dagenham,E09000002,185911,108386,7878,29594,37140,2913,127568,86404,71519,14885,41164
2011,Barnet,E09000003,356386,228553,17169,65918,27431,17315,258443,184483,163942,20541,73960
2011,Bexley,E09000004,231997,189962,5395,15243,19624,1773,165914,118864,106286,12578,47050
2011,Brent,E09000005,311215,112880,15775,105986,58632,17942,233726,163991,139478,24513,69735
2011,Bromley,E09000006,309392,260870,10897,16067,18686,2872,222539,161282,147108,14174,61257
2011,Croydon,E09000008,363378,200195,23895,59627,73256,6405,263048,190308,165753,24555,72740
2011,Ealing,E09000009,338449,165818,15066,100439,36860,20266,252764,180615,157500,23115,72149
2011,Enfield,E09000010,312466,190640,17183,34893,53687,16063,224024,153334,131601,21733,70690
2011,Greenwich,E09000011,254557,159002,12274,29894,48655,4732,186722,132073,110846,21227,54649
2011,Harrow,E09000015,239056,100991,9499,101808,19708,7050,174751,123307,109034,14273,51444
2011,Havering,E09000016,237232,207949,4933,11545,11481,1324,171128,121642,109446,12196,49486
2011,Hillingdon,E09000017,273936,166031,10479,69253,20082,8091,199926,141542,123188,18354,58384
2011,Hounslow,E09000018,253957,130505,10349,87257,16813,9033,190157,137867,120742,17125,52290
2011,Kingston upon Thames,E09000021,160060,119219,6269,26152,4021,4399,119673,87348,77126,10222,32325
2011,Merton,E09000024,199693,129606,9334,36143,20811,3799,149598,112038,100904,11134,37560
2011,Redbridge,E09000026,278970,118646,11456,116503,24845,7520,199544,137776,119012,18764,61768
2011,Richmond upon Thames,E09000027,186990,160725,6780,13607,2816,3062,137779,104090,96185,7905,33689
2011,Sutton,E09000029,190146,149449,7134,22035,9120,2408,138710,103995,94432,9563,34715
2011,Waltham Forest,E09000031,258249,134799,13766,54389,44791,10504,190978,135015,114964,20051,55963
2011,Bracknell Forest,E06000036,113205,102554,2303,5664,2189,495,83116,65137,59995,5142,17979
2011,Brighton and Hove,E06000043,273369,243512,10408,11278,4188,3983,210792,150853,130732,20121,59939
2011,Isle of Wight,E06000046,138265,134545,1709,1514,303,194,99747,64218,57634,6584,35529
2011,Medway,E06000035,263925,236579,5176,13615,6663,1892,194158,137954,121925,16029,56204
2011,Milton Keynes,E06000042,248821,199094,8235,22782,17131,1579,181385,137717,123379,14338,43668
2011,Portsmouth,E06000044,205056,181182,5467,12474,3777,2156,153705,105834,89920,15914,47871
2011,Reading,E06000038,155698,116387,6180,21161,10470,1500,116808,86329,75175,11154,30479
2011,Slough,E06000039,140205,64053,4758,55697,12115,3582,100458,73819,64422,9397,26639
2011,Southampton,E06000045,236882,203528,5678,19892,5067,2717,180201,123193,103902,19291,57008
2011,West Berkshire,E06000037,153822,145854,2420,3808,1376,364,112054,85401,79342,6059,26653
2011,Windsor and Maidenhead,E06000040,144560,124505,3315,13848,1725,1167,104247,77650,71967,5683,26597
2011,Wokingham,E06000041,154380,136525,3182,11438,2093,1142,112273,84912,78623,6289,27361
2011,Aylesbury Vale,E07000004,174137,156079,3864,10105,3323,766,126740,95242,87978,7264,31498
2011,Chiltern,E07000005,92635,84749,2040,5046,524,276,65043,46743,43418,3325,18300
2011,South Bucks,E07000006,66867,56365,1607,7533,709,653,47802,34581,32159,2422,13221
2011,Wycombe,E07000007,171644,139477,4849,20585,5934,799,124188,91315,82833,8482,32873
2011,Eastbourne,E07000061,99412,93508,1791,2795,783,535,70473,47926,42342,5584,22547
2011,Hastings,E07000062,90254,84631,1948,2126,1065,484,66036,44759,39256,5503,21277
2011,Lewes,E07000063,97502,94159,1275,1400,416,252,69269,48194,44029,4165,21075
2011,Rother,E07000064,90588,87951,1031,1103,305,198,62861,39859,36504,3355,23002
2011,Wealden,E07000065,148915,145173,1428,1719,343,252,105879,74214,68798,5416,31665
2011,Basingstoke and Deane,E07000084,167799,155888,2813,6715,1909,474,123243,94800,87347,7453,28443
2011,East Hampshire,E07000085,115608,111635,1305,1859,517,292,83522,60953,56610,4343,22569
2011,Eastleigh,E07000086,125199,118537,1740,3740,605,577,91582,69033,63539,5494,22549
2011,Fareham,E07000087,111581,107959,1359,1667,357,239,81198,59063,54335,4728,22135
2011,Gosport,E07000088,82622,79685,1066,1073,592,206,59499,42981,38861,4120,16518
2011,Hart,E07000089,91033,86355,1457,2448,506,267,66087,49875,46585,3290,16212
2011,Havant,E07000090,120684,117162,1514,1427,388,193,86247,59601,53672,5929,26646
2011,New Forest,E07000091,176462,172160,1620,1665,612,405,124798,86776,80253,6523,38022
2011,Rushmoor,E07000092,93807,79520,2057,9755,1868,607,69652,54145,49311,4834,15507
2011,Test Valley,E07000093,116398,111645,1494,2368,487,404,84652,62141,57783,4358,22511
2011,Winchester,E07000094,116595,111577,1626,2639,457,296,84495,60029,54075,5954,24466
2011,Ashford,E07000105,117956,110520,1682,3991,1375,388,84252,61189,55559,5630,23063
2011,Canterbury,E07000106,151145,140620,2551,5135,1937,902,111867,71322,59993,11329,40545
2011,Dartford,E07000107,97365,85070,2161,5799,3578,757,70488,53184,48120,5064,17304
2011,Dover,E07000108,111674,107966,1029,2031,386,262,80786,54478,48919,5559,26308
2011,Gravesham,E07000109,101720,84226,2066,10604,2885,1939,73191,51903,46129,5774,21288
2011,Maidstone,E07000110,155143,145996,2345,4943,1380,479,113231,82528,75777,6751,30703
2011,Sevenoaks,E07000111,114893,110029,1675,2085,853,251,82098,58707,54533,4174,23391
2011,Folkestone and Hythe,E07000112,107969,102215,1267,3699,458,330,77938,52387,46534,5853,25551
2011,Swale,E07000113,135835,131155,1575,1489,1395,221,98607,67913,61155,6758,30694
2011,Thanet,E07000114,134186,128194,2186,2504,910,392,94452,61272,53119,8153,33180
2011,Tonbridge and Malling,E07000115,120805,115872,1677,2431,421,404,86435,63039,58121,4918,23396
2011,Tunbridge Wells,E07000116,115049,109239,1893,2903,638,376,82052,59986,55524,4462,22066
2011,Cherwell,E07000177,141868,130761,2560,6039,1961,547,103269,78160,72552,5608,25109
2011,Oxford,E07000178,151906,117957,6035,18827,7028,2059,118437,74923,63453,11470,43514
2011,South Oxfordshire,E07000179,134257,128993,1801,2405,768,290,96892,72820,68205,4615,24072
2011,Vale of White Horse,E07000180,120988,114824,1574,2962,1230,398,87477,65710,61185,4525,21767
2011,West Oxfordshire,E07000181,104779,101469,1263,1424,437,186,76163,58506,54940,3566,17657
2011,Elmbridge,E07000207,130875,118123,3411,7075,1010,1256,92027,67522,62942,4580,24505
2011,Epsom and Ewell,E07000208,75102,64502,1922,6484,1128,1066,54170,39844,36449,3395,14326
2011,Guildford,E07000209,137183,124707,2501,6616,1656,1703,102054,73649,65900,7749,28405
2011,Mole Valley,E07000210,85375,81168,1257,2177,399,374,60778,44170,41169,3001,16608
2011,Reigate and Banstead,E07000211,137835,124879,3037,6992,2166,761,99173,74614,69231,5383,24559
2011,Runnymede,E07000212,80510,71633,1671,5561,862,783,59793,42816,38321,4495,16977
2011,Spelthorne,E07000213,95598,83455,2382,7295,1545,921,69916,52767,48765,4002,17149
2011,Surrey Heath,E07000214,86144,77692,1626,5389,861,576,62565,47016,43500,3516,15549
2011,Tandridge,E07000215,82998,77880,1789,2164,882,283,59457,43692,40722,2970,15765
2011,Waverley,E07000216,121572,116717,1623,2283,538,411,85617,61649,57117,4532,23968
2011,Woking,E07000217,99198,82926,2335,11462,1383,1092,71722,54052,49576,4476,17670
2011,Adur,E07000223,61182,58663,886,1058,313,262,43860,31054,28482,2572,12806
2011,Arun,E07000224,149518,145118,1502,2116,538,244,106071,71573,65185,6388,34498
2011,Chichester,E07000225,113794,110322,1092,1617,518,245,81037,56102,51005,5097,24935
2011,Crawley,E07000226,106597,85180,3098,13825,3469,1025,77348,59495,53637,5858,17853
2011,Horsham,E07000227,131301,126062,1774,2585,651,229,94318,69240,64165,5075,25078
2011,Mid Sussex,E07000228,139860,133018,1967,3761,788,326,100252,75025,69941,5084,25227
2011,Worthing,E07000229,104640,98136,1836,3372,869,427,74338,53630,48704,4926,20708
2011,Bath and North East Somerset,E06000022,176016,166473,2898,4577,1326,742,130550,89752,79491,10261,40798
2011,Bournemouth,E06000028,183491,168797,4191,7066,1764,1673,137574,96017,83404,12613,41557
2011,"Bristol, City of",E06000023,428234,359592,15438,23655,25734,3815,321506,227119,197915,29204,94387
2011,Cornwall,E06000052,532273,522848,4400,3434,762,829,388858,259484,235986,23498,129374
2011,Isles of Scilly,E06000053,2203,2177,18,2,2,4,1622,1331,1306,25,291
2011,North Somerset,E06000024,202566,197076,2033,2436,632,389,145352,102607,94139,8468,42745
2011,Plymouth,E06000026,256384,246509,3287,3906,1678,1004,191786,127742,110706,17036,64044
2011,Poole,E06000029,147645,141523,1916,3276,520,410,106391,75720,69143,6577,30671
2011,South Gloucestershire,E06000025,262767,249574,3667,6440,2218,868,192468,143198,131089,12109,49270
2011,Swindon,E06000030,209156,187898,4226,13365,2861,806,154080,117039,106110,10929,37041
2011,Torbay,E06000027,130959,127699,1420,1353,251,236,94000,61795,55066,6729,32205
2011,Wiltshire,E06000054,470981,454971,5568,6178,3228,1036,339595,250792,232126,18666,88803
2011,East Devon,E07000040,132457,130347,904,930,146,130,92782,62455,58078,4377,30327
2011,Exeter,E07000041,117773,109590,1938,4595,667,983,89544,60870,53133,7737,28674
2011,Mid Devon,E07000042,77750,76696,484,428,94,48,55847,40218,37514,2704,15629
2011,North Devon,E07000043,93667,91742,785,835,158,147,67507,47119,43382,3737,20388
2011,South Hams,E07000044,83140,81784,653,458,121,124,60617,41639,38735,2904,18978
2011,Teignbridge,E07000045,124220,122163,925,893,117,122,89471,61845,57108,4737,27626
2011,Torridge,E07000046,63839,63021,429,271,51,67,46510,31158,28692,2466,15352
2011,West Devon,E07000047,53553,52730,402,300,59,62,38941,26543,24473,2070,12398
2011,Christchurch,E07000048,47752,46591,505,495,83,78,32645,21420,19631,1789,11225
2011,East Dorset,E07000049,87166,85645,594,737,106,84,61047,41576,38603,2973,19471
2011,North Dorset,E07000050,68583,66977,552,796,197,61,49140,34878,32614,2264,14262
2011,Purbeck,E07000051,44973,44340,326,231,48,28,32379,22400,20743,1657,9979
2011,West Dorset,E07000052,99264,97284,770,934,169,107,70359,47566,44312,3254,22793
2011,Weymouth and Portland,E07000053,65167,63480,653,640,321,73,47871,32103,29046,3057,15768
2011,Cheltenham,E07000078,115732,109084,1878,3675,721,374,86090,62763,55838,6925,23327
2011,Cotswold,E07000079,82881,81075,698,794,229,85,60075,43206,40303,2903,16869
2011,Forest of Dean,E07000080,81961,80699,528,473,199,62,60341,41490,37834,3656,18851
2011,Gloucester,E07000081,121688,108462,3565,5839,3486,336,88942,65740,58990,6750,23202
2011,Stroud,E07000082,112779,110426,1216,751,260,126,81955,59980,55589,4391,21975
2011,Tewkesbury,E07000083,81943,79901,776,901,255,110,59685,43454,40346,3108,16231
2011,Mendip,E07000187,109279,107057,996,929,210,87,78653,56462,52172,4290,22191
2011,Sedgemoor,E07000188,114588,112724,869,735,140,120,82903,57966,52751,5215,24937
2011,South Somerset,E07000189,161243,158130,1158,1409,357,189,115790,82390,76498,5892,33400
2011,Taunton Deane,E07000190,110187,107116,1010,1608,286,167,78921,56832,52280,4552,22089
2011,West Somerset,E07000191,34675,34228,208,192,20,27,24918,16118,14985,1133,8800
2011,Isle of Anglesey,W06000001,69751,68520,480,491,81,179,50818,33023,29423,3600,17795
2011,Gwynedd,W06000002,121874,117573,964,2170,289,878,88913,57995,51063,6932,30918
2011,Conwy,W06000003,115228,112549,894,1252,199,334,81906,53792,48239,5553,28114
2011,Denbighshire,W06000004,93734,91254,751,1430,161,138,67676,44409,39788,4621,23267
2011,Flintshire,W06000005,152506,150161,851,1201,142,151,112325,78957,71539,7418,33368
2011,Wrexham,W06000006,134844,130647,1010,2321,625,241,98691,68413,61123,7290,30278
2011,Powys,W06000023,132976,130827,760,1142,132,115,96069,66846,61870,4976,29223
2011,Ceredigion,W06000008,75922,73443,736,1099,266,378,57405,35064,30031,5033,22341
2011,Pembrokeshire,W06000009,122439,120121,733,1192,179,214,88049,58120,52601,5519,29929
2011,Carmarthenshire,W06000010,183777,180323,1033,1837,279,305,132930,86217,77956,8261,46713
2011,Swansea,W06000011,239023,224697,2160,7803,1983,2380,176971,111460,96413,15047,65511
2011,Neath Port Talbot,W06000012,139812,137087,910,1369,299,147,102986,64110,57220,6890,38876
2011,Bridgend,W06000013,139178,136090,998,1549,315,226,102805,66449,59433,7016,36356
2011,Vale of Glamorgan,W06000014,126336,121838,1695,1967,489,347,91816,63384,57143,6241,28432
2011,Cardiff,W06000015,346090,293114,10031,27885,8201,6859,260268,174753,147955,26798,85515
2011,Rhondda Cynon Taff,W06000016,234410,228241,1506,3030,1308,325,172047,108730,95326,13404,63317
2011,Merthyr Tydfil,W06000024,58802,57391,462,696,143,110,43377,27833,24285,3548,15544
2011,Caerphilly,W06000018,178806,175845,1174,1346,242,199,130950,84932,75354,9578,46018
2011,Blaenau Gwent,W06000019,69814,68750,394,485,95,90,51809,32145,27516,4629,19664
2011,Torfaen,W06000020,91075,89231,603,977,169,95,66107,43820,38965,4855,22287
2011,Monmouthshire,W06000021,91323,89526,624,900,144,129,66107,45272,41554,3718,20835
2011,Newport,W06000022,145736,131025,2752,7986,2535,1438,105141,71011,61602,9409,34130
