x,y,year,geography code,geography,Ethnic Total,White,Mixed,Asian,Black,Other,Economic Total,Economically active,Economically active: In employment,Economically active: Unemployed,Economically inactive
15.021822,4.759676,2011,E06000001,Hartlepool,92028,89899,550,1304,170,105,66804,43513,36532,6981,23291
15.355503,3.4913156,2011,E06000002,Middlesbrough,138412,122055,2362,10768,1731,1496,100551,63582,51535,12047,36969
14.87558,3.7104328,2011,E06000003,Redcar and Cleveland,135177,133203,853,869,122,130,99177,63530,54558,8972,35647
14.380466,2.2740695,2011,E06000004,Stockton-on-Tees,191610,181299,1997,6632,1133,549,140654,96259,83938,12321,44395
15.196974,4.5005307,2011,E06000005,Darlington,105564,101595,1146,2205,357,261,76635,53443,47487,5956,23192
15.076397,3.9553926,2011,E06000006,Halton,125746,123041,1356,943,260,146,92708,63411,55741,7670,29297
14.009884,2.064998,2011,E06000007,Warrington,202228,193992,2144,4911,694,487,149461,107765,97274,10491,41696
14.35663,3.1453502,2011,E06000008,Blackburn with Darwen,147489,102009,1823,41494,933,1230,104417,67033,58129,8904,37384
14.99655,3.5240777,2011,E06000009,Blackpool,142065,137339,1753,2282,346,345,103813,68540,59026,9514,35273
13.0137825,0.8853897,2011,E06000010,"Kingston upon Hull, City of",256406,241321,3454,6471,2996,2164,190610,128130,105890,22240,62480
10.34893,1.0573057,2011,E06000011,East Riding of Yorkshire,334179,327789,2301,2961,598,530,245594,168860,153451,15409,76734
14.779997,3.1058671,2011,E06000012,North East Lincolnshire,159616,155421,1186,2129,411,469,115823,79227,68609,10618,36596
14.710375,2.9510343,2011,E06000013,North Lincolnshire,167446,160748,1244,4549,494,411,122329,84668,75915,8753,37661
14.3585415,2.0115368,2011,E06000014,York,198051,186731,2413,6740,1194,973,149789,104945,91847,13098,44844
15.013557,0.42635673,2011,E06000015,Derby,248752,199751,7232,31095,7320,3354,179291,123691,106946,16745,55600
9.386103,-1.5765071,2011,E06000016,Leicester,329839,166636,11580,122470,20585,8568,242232,156425,128142,28283,85807
13.857073,5.5742426,2011,E06000017,Rutland,37369,36301,389,365,251,63,27052,18758,17509,1249,8294
10.669824,-1.3869976,2011,E06000018,Nottingham,305680,218698,20265,40039,22185,4493,232072,142327,112861,29466,89745
14.152605,2.5924344,2011,E06000019,"Herefordshire, County of",183477,180169,1270,1439,331,268,133442,95114,87590,7524,38328
14.947367,2.8736632,2011,E06000020,Telford and Wrekin,166641,154415,2983,6991,1779,473,122279,84947,75685,9262,37332
13.972218,0.97185963,2011,E06000021,Stoke-on-Trent,249008,220712,4491,18442,3741,1622,182808,119743,103269,16474,63065
14.781881,2.6054237,2011,E06000022,Bath and North East Somerset,176016,166473,2898,4577,1326,742,130550,89752,79491,10261,40798
8.155014,0.24231437,2011,E06000023,"Bristol, City of",428234,359592,15438,23655,25734,3815,321506,227119,197915,29204,94387
13.905014,2.1816504,2011,E06000024,North Somerset,202566,197076,2033,2436,632,389,145352,102607,94139,8468,42745
12.664209,1.0642557,2011,E06000025,South Gloucestershire,262767,249574,3667,6440,2218,868,192468,143198,131089,12109,49270
12.838236,1.0847319,2011,E06000026,Plymouth,256384,246509,3287,3906,1678,1004,191786,127742,110706,17036,64044
15.048426,3.9037452,2011,E06000027,Torbay,130959,127699,1420,1353,251,236,94000,61795,55066,6729,32205
14.960735,2.228628,2011,E06000028,Bournemouth,183491,168797,4191,7066,1764,1673,137574,96017,83404,12613,41557
15.008738,3.478909,2011,E06000029,Poole,147645,141523,1916,3276,520,410,106391,75720,69143,6577,30671
14.254274,1.7472551,2011,E06000030,Swindon,209156,187898,4226,13365,2861,806,154080,117039,106110,10929,37041
15.201749,2.2428792,2011,E06000031,Peterborough,183631,151544,4948,21492,4164,1483,132318,95646,85370,10276,36672
13.9329815,0.29853076,2011,E06000032,Luton,203201,111079,8281,60952,19909,2980,145208,100272,83876,16396,44936
15.098108,2.693537,2011,E06000033,Southend-on-Sea,173658,159023,3651,6440,3647,897,125007,88324,78722,9602,36683
15.392721,2.9671872,2011,E06000034,Thurrock,157705,135429,3099,5927,12323,927,114124,84464,75151,9313,29660
13.9305725,0.7480728,2011,E06000035,Medway,263925,236579,5176,13615,6663,1892,194158,137954,121925,16029,56204
15.285708,4.258787,2011,E06000036,Bracknell Forest,113205,102554,2303,5664,2189,495,83116,65137,59995,5142,17979
14.837084,3.2558756,2011,E06000037,West Berkshire,153822,145854,2420,3808,1376,364,112054,85401,79342,6059,26653
15.333593,2.5349452,2011,E06000038,Reading,155698,116387,6180,21161,10470,1500,116808,86329,75175,11154,30479
13.782112,2.4129362,2011,E06000039,Slough,140205,64053,4758,55697,12115,3582,100458,73819,64422,9397,26639
15.332776,3.4676712,2011,E06000040,Windsor and Maidenhead,144560,124505,3315,13848,1725,1167,104247,77650,71967,5683,26597
15.244786,3.2001255,2011,E06000041,Wokingham,154380,136525,3182,11438,2093,1142,112273,84912,78623,6289,27361
14.342424,0.33042085,2011,E06000042,Milton Keynes,248821,199094,8235,22782,17131,1579,181385,137717,123379,14338,43668
13.234928,0.12718683,2011,E06000043,Brighton and Hove,273369,243512,10408,11278,4188,3983,210792,150853,130732,20121,59939
14.830365,1.5204601,2011,E06000044,Portsmouth,205056,181182,5467,12474,3777,2156,153705,105834,89920,15914,47871
14.520346,0.7607027,2011,E06000045,Southampton,236882,203528,5678,19892,5067,2717,180201,123193,103902,19291,57008
14.940804,3.7059186,2011,E06000046,Isle of Wight,138265,134545,1709,1514,303,194,99747,64218,57634,6584,35529
5.3455844,1.8715106,2011,E06000047,County Durham,513242,503769,3094,4856,701,822,383796,247101,219826,27275,136695
9.730565,1.1945378,2011,E06000049,Cheshire East,370127,357940,3873,6060,1402,852,270953,191253,174859,16394,79700
10.623764,1.0117072,2011,E06000050,Cheshire West and Chester,329608,321025,3050,4097,908,528,243155,170778,153704,17074,72377
10.922719,0.9888085,2011,E06000051,Shropshire,306129,299874,2168,3089,580,418,223892,158983,146401,12582,64909
4.915233,1.7695187,2011,E06000052,Cornwall,532273,522848,4400,3434,762,829,388858,259484,235986,23498,129374
12.431826,5.6092405,2011,E06000053,Isles of Scilly,2203,2177,18,2,2,4,1622,1331,1306,25,291
6.5308747,1.6556507,2011,E06000054,Wiltshire,470981,454971,5568,6178,3228,1036,339595,250792,232126,18666,88803
15.341411,2.8616352,2011,E06000055,Bedford,157479,126846,5386,17932,6202,1113,113764,81782,72610,9172,31982
13.005093,1.0705075,2011,E06000056,Central Bedfordshire,254381,238722,4789,6402,3614,854,186658,139525,127845,11680,47133
10.644872,1.0305016,2011,E06000057,Northumberland,316028,311066,1692,2658,338,274,233224,158268,142811,15457,74956
14.899231,2.65786,2011,E07000004,Aylesbury Vale,174137,156079,3864,10105,3323,766,126740,95242,87978,7264,31498
15.051186,4.809514,2011,E07000005,Chiltern,92635,84749,2040,5046,524,276,65043,46743,43418,3325,18300
14.778138,5.265037,2011,E07000006,South Bucks,66867,56365,1607,7533,709,653,47802,34581,32159,2422,13221
15.123309,2.5672944,2011,E07000007,Wycombe,171644,139477,4849,20585,5934,799,124188,91315,82833,8482,32873
15.543071,3.6596951,2011,E07000008,Cambridge,123867,102205,3944,13618,2097,2003,98283,62886,54642,8244,35397
14.955659,4.9600315,2011,E07000009,East Cambridgeshire,83818,80673,1182,1215,506,242,60714,45920,42764,3156,14794
15.07268,4.7388816,2011,E07000010,Fenland,95262,92631,901,1075,497,158,69258,47829,43413,4416,21429
14.675731,2.8201232,2011,E07000011,Huntingdonshire,169508,160691,2530,4190,1642,455,125346,93481,86207,7274,31865
15.012775,3.40369,2011,E07000012,South Cambridgeshire,148755,138787,2524,5540,1268,636,107779,82079,76608,5471,25700
14.983551,4.700637,2011,E07000026,Allerdale,96422,95385,426,477,73,61,70978,48904,44833,4071,22074
14.71469,5.2074847,2011,E07000027,Barrow-in-Furness,69087,67940,360,633,70,84,51103,33897,30348,3549,17206
15.087162,4.4360065,2011,E07000028,Carlisle,107524,105480,535,1248,147,114,79531,57210,51767,5443,22321
14.72111,5.1783504,2011,E07000029,Copeland,70603,69491,339,629,84,60,52702,35335,32184,3151,17367
14.307176,5.433734,2011,E07000030,Eden,52564,51999,211,292,22,40,38735,28413,26527,1886,10322
14.980895,4.554454,2011,E07000031,South Lakeland,103658,101962,633,787,183,93,75831,53396,49980,3416,22435
15.038483,4.078615,2011,E07000032,Amber Valley,122309,120023,980,929,253,124,90558,63280,57786,5494,27278
14.81749,5.09223,2011,E07000033,Bolsover,75866,74452,518,612,267,17,55945,37442,33578,3864,18503
15.14764,4.526551,2011,E07000034,Chesterfield,103788,100172,1094,1592,782,148,76409,51909,46543,5366,24500
14.691795,5.183658,2011,E07000035,Derbyshire Dales,71116,70117,466,398,87,48,51978,36541,34001,2540,15437
15.141856,4.3188314,2011,E07000036,Erewash,112081,108765,1269,1383,536,128,82609,59044,53309,5735,23565
15.024926,4.792248,2011,E07000037,High Peak,90892,88954,944,711,184,99,67389,48560,44173,4387,18829
15.046316,4.6310306,2011,E07000038,North East Derbyshire,99023,97084,786,795,236,122,73460,49919,45568,4351,23541
15.090958,4.7420244,2011,E07000039,South Derbyshire,94611,90527,1062,2375,425,222,69450,50358,46409,3949,19092
14.887002,3.9552596,2011,E07000040,East Devon,132457,130347,904,930,146,130,92782,62455,58078,4377,30327
15.444304,4.0912504,2011,E07000041,Exeter,117773,109590,1938,4595,667,983,89544,60870,53133,7737,28674
14.779196,5.0865183,2011,E07000042,Mid Devon,77750,76696,484,428,94,48,55847,40218,37514,2704,15629
15.0060625,4.785506,2011,E07000043,North Devon,93667,91742,785,835,158,147,67507,47119,43382,3737,20388
14.871099,4.979575,2011,E07000044,South Hams,83140,81784,653,458,121,124,60617,41639,38735,2904,18978
14.983509,4.0939837,2011,E07000045,Teignbridge,124220,122163,925,893,117,122,89471,61845,57108,4737,27626
14.558891,5.2956924,2011,E07000046,Torridge,63839,63021,429,271,51,67,46510,31158,28692,2466,15352
14.331028,5.4279838,2011,E07000047,West Devon,53553,52730,402,300,59,62,38941,26543,24473,2070,12398
14.12913,5.506079,2011,E07000048,Christchurch,47752,46591,505,495,83,78,32645,21420,19631,1789,11225
14.877212,4.9465594,2011,E07000049,East Dorset,87166,85645,594,737,106,84,61047,41576,38603,2973,19471
14.640179,5.238359,2011,E07000050,North Dorset,68583,66977,552,796,197,61,49140,34878,32614,2264,14262
14.080139,5.5157804,2011,E07000051,Purbeck,44973,44340,326,231,48,28,32379,22400,20743,1657,9979
14.967661,4.693492,2011,E07000052,West Dorset,99264,97284,770,934,169,107,70359,47566,44312,3254,22793
14.6401205,5.269875,2011,E07000053,Weymouth and Portland,65167,63480,653,640,321,73,47871,32103,29046,3057,15768
15.256922,4.66024,2011,E07000061,Eastbourne,99412,93508,1791,2795,783,535,70473,47926,42342,5584,22547
15.186865,4.796197,2011,E07000062,Hastings,90254,84631,1948,2126,1065,484,66036,44759,39256,5503,21277
15.097999,4.717695,2011,E07000063,Lewes,97502,94159,1275,1400,416,252,69269,48194,44029,4165,21075
14.935135,4.8843665,2011,E07000064,Rother,90588,87951,1031,1103,305,198,62861,39859,36504,3355,23002
14.826824,3.5049841,2011,E07000065,Wealden,148915,145173,1428,1719,343,252,105879,74214,68798,5416,31665
14.94139,2.727917,2011,E07000066,Basildon,174497,161677,2887,4766,4685,482,125795,89570,80665,8905,36225
14.924541,3.4610894,2011,E07000067,Braintree,147084,142087,1837,1998,913,249,106718,78715,72016,6699,28003
14.860144,5.160906,2011,E07000068,Brentwood,73601,68868,1196,2350,896,291,52959,38149,35283,2866,14810
15.010249,4.8775744,2011,E07000069,Castle Point,88011,85273,911,1012,661,154,64626,44080,40222,3858,20546
14.887516,2.8535411,2011,E07000070,Chelmsford,168310,157983,2646,4962,2051,668,123693,91339,83355,7984,32354
15.2506075,2.6221817,2011,E07000071,Colchester,173074,159306,3152,6355,2575,1686,128562,91385,81214,10171,37177
15.422212,4.018068,2011,E07000072,Epping Forest,124659,112869,2649,5922,2404,815,90622,65304,59936,5368,25318
15.135536,4.992676,2011,E07000073,Harlow,81944,72999,1752,3733,3090,370,58669,43847,39010,4837,14822
14.536596,5.3200827,2011,E07000074,Maldon,61629,60429,506,484,150,60,45406,31856,29513,2343,13550
14.927887,4.978488,2011,E07000075,Rochford,83287,80937,905,881,433,131,60425,42804,39503,3301,17621
14.898069,3.763529,2011,E07000076,Tendring,138048,134667,1467,1275,434,205,97050,59908,53285,6623,37142
14.870385,5.0529613,2011,E07000077,Uttlesford,79443,76761,977,1122,417,166,57086,42473,39603,2870,14613
15.280275,4.1843634,2011,E07000078,Cheltenham,115732,109084,1878,3675,721,374,86090,62763,55838,6925,23327
14.873421,4.987189,2011,E07000079,Cotswold,82881,81075,698,794,229,85,60075,43206,40303,2903,16869
14.891418,4.988976,2011,E07000080,Forest of Dean,81961,80699,528,473,199,62,60341,41490,37834,3656,18851
15.287994,3.9783027,2011,E07000081,Gloucester,121688,108462,3565,5839,3486,336,88942,65740,58990,6750,23202
15.045166,4.3329096,2011,E07000082,Stroud,112779,110426,1216,751,260,126,81955,59980,55589,4391,21975
14.891752,4.9980326,2011,E07000083,Tewkesbury,81943,79901,776,901,255,110,59685,43454,40346,3108,16231
14.736715,2.8433611,2011,E07000084,Basingstoke and Deane,167799,155888,2813,6715,1909,474,123243,94800,87347,7453,28443
15.121593,4.288459,2011,E07000085,East Hampshire,115608,111635,1305,1859,517,292,83522,60953,56610,4343,22569
15.222942,4.0097914,2011,E07000086,Eastleigh,125199,118537,1740,3740,605,577,91582,69033,63539,5494,22549
15.131985,4.3617773,2011,E07000087,Fareham,111581,107959,1359,1667,357,239,81198,59063,54335,4728,22135
14.992337,4.9922657,2011,E07000088,Gosport,82622,79685,1066,1073,592,206,59499,42981,38861,4120,16518
15.035351,4.812631,2011,E07000089,Hart,91033,86355,1457,2448,506,267,66087,49875,46585,3290,16212
15.131109,4.166244,2011,E07000090,Havant,120684,117162,1514,1427,388,193,86247,59601,53672,5929,26646
14.44327,2.8378727,2011,E07000091,New Forest,176462,172160,1620,1665,612,405,124798,86776,80253,6523,38022
15.27297,4.69684,2011,E07000092,Rushmoor,93807,79520,2057,9755,1868,607,69652,54145,49311,4834,15507
15.157619,4.255009,2011,E07000093,Test Valley,116398,111645,1494,2368,487,404,84652,62141,57783,4358,22511
15.212285,4.237898,2011,E07000094,Winchester,116595,111577,1626,2639,457,296,84495,60029,54075,5954,24466
15.347759,4.7533712,2011,E07000095,Broxbourne,93609,84530,2141,2190,3957,791,67599,49426,44754,4672,18173
15.219189,3.476689,2011,E07000096,Dacorum,144847,131537,3075,6770,2990,475,104410,77800,71048,6752,26610
15.451685,4.61277,2011,E07000098,Hertsmere,100031,85063,2619,7393,3927,1029,71511,52435,47789,4646,19076
15.31802,3.9137442,2011,E07000099,North Hertfordshire,127114,113755,3376,6821,2491,671,91510,68564,62969,5595,22946
15.114681,4.896713,2011,E07000102,Three Rivers,87317,75294,2002,7993,1610,418,62440,46280,42662,3618,16160
15.190609,4.671565,2011,E07000103,Watford,90301,64946,3104,16170,5229,852,66285,50770,45809,4961,15515
15.292685,4.24176,2011,E07000105,Ashford,117956,110520,1682,3991,1375,388,84252,61189,55559,5630,23063
15.120928,3.1815352,2011,E07000106,Canterbury,151145,140620,2551,5135,1937,902,111867,71322,59993,11329,40545
15.401974,4.665928,2011,E07000107,Dartford,97365,85070,2161,5799,3578,757,70488,53184,48120,5064,17304
15.164978,4.3800006,2011,E07000108,Dover,111674,107966,1029,2031,386,262,80786,54478,48919,5559,26308
15.6467705,4.5695972,2011,E07000109,Gravesham,101720,84226,2066,10604,2885,1939,73191,51903,46129,5774,21288
14.989319,3.2384846,2011,E07000110,Maidstone,155143,145996,2345,4943,1380,479,113231,82528,75777,6751,30703
15.132313,4.3174257,2011,E07000111,Sevenoaks,114893,110029,1675,2085,853,251,82098,58707,54533,4174,23391
15.22906,4.4623823,2011,E07000112,Folkestone and Hythe,107969,102215,1267,3699,458,330,77938,52387,46534,5853,25551
15.095357,3.7631116,2011,E07000113,Swale,135835,131155,1575,1489,1395,221,98607,67913,61155,6758,30694
15.143999,3.8116238,2011,E07000114,Thanet,134186,128194,2186,2504,910,392,94452,61272,53119,8153,33180
15.172733,4.169999,2011,E07000115,Tonbridge and Malling,120805,115872,1677,2431,421,404,86435,63039,58121,4918,23396
15.181923,4.306529,2011,E07000116,Tunbridge Wells,115049,109239,1893,2903,638,376,82052,59986,55524,4462,22066
15.063519,4.898301,2011,E07000117,Burnley,87059,76054,976,9578,211,240,63376,41879,36907,4972,21497
15.122183,4.43803,2011,E07000118,Chorley,107155,103833,1016,1710,401,195,79951,56645,52009,4636,23306
14.812468,5.121823,2011,E07000119,Fylde,75757,73844,742,845,163,163,54544,36447,33285,3162,18097
14.948924,5.0313864,2011,E07000120,Hyndburn,80734,70778,696,9007,106,147,58356,39118,34663,4455,19238
15.047052,3.6062639,2011,E07000121,Lancaster,138375,132342,1356,3732,628,317,103296,67262,58498,8764,36034
14.930691,4.8238373,2011,E07000122,Pendle,89452,71437,946,16807,126,136,64440,42765,37965,4800,21675
15.252344,3.3303814,2011,E07000123,Preston,140202,112415,3326,21732,1676,1053,104085,70509,59350,11159,33576
14.414295,5.390312,2011,E07000124,Ribble Valley,57132,55904,360,729,92,47,41285,29672,27612,2060,11613
14.731745,5.234087,2011,E07000125,Rossendale,67982,63778,602,3396,123,83,50075,35186,31864,3322,14889
15.104088,4.398673,2011,E07000126,South Ribble,109057,105847,1174,1612,268,156,80458,58577,53816,4761,21881
15.114162,4.343598,2011,E07000127,West Lancashire,110685,108603,866,913,174,129,81601,55680,48969,6711,25921
15.041928,4.4781837,2011,E07000128,Wyre,107749,105852,664,993,130,110,77663,51450,46576,4874,26213
15.165627,4.759162,2011,E07000129,Blaby,93915,85451,1505,5718,900,341,68558,50661,46701,3960,17897
15.121898,2.8108275,2011,E07000130,Charnwood,166100,145114,2577,16138,1327,944,124967,84609,75236,9373,40358
14.965505,4.942604,2011,E07000131,Harborough,85382,81316,971,2563,327,205,61913,45791,42742,3049,16122
15.098764,4.497504,2011,E07000132,Hinckley and Bosworth,105078,101369,1027,2246,262,174,77716,56538,52259,4279,21178
14.2709255,5.457152,2011,E07000133,Melton,50376,49319,414,518,95,30,36955,27422,25358,2064,9533
15.027959,4.761813,2011,E07000134,North West Leicestershire,93468,91187,881,1074,205,121,68556,48999,44994,4005,19557
14.536236,5.3899927,2011,E07000135,Oadby and Wigston,56170,41011,1176,12520,671,792,40797,28119,25226,2893,12678
14.663357,5.2873015,2011,E07000136,Boston,64637,62592,664,928,278,175,47306,33031,30070,2961,14275
14.748301,3.7335732,2011,E07000137,East Lindsey,136401,134314,937,789,264,97,99928,60716,54875,5841,39212
15.177008,4.617114,2011,E07000138,Lincoln,93541,89379,1230,1794,778,360,71577,49523,40981,8542,22054
15.044365,4.463228,2011,E07000139,North Kesteven,107766,105835,791,750,251,139,78616,55065,50921,4144,23551
14.966375,4.884638,2011,E07000140,South Holland,88270,86370,796,747,257,100,63920,44276,40532,3744,19644
14.992268,3.824376,2011,E07000141,South Kesteven,133788,130394,1142,1580,509,163,97319,70273,64499,5774,27046
14.971777,4.8498044,2011,E07000142,West Lindsey,89250,87600,630,728,224,68,65531,44768,40734,4034,20763
15.031064,3.9187357,2011,E07000143,Breckland,130491,127116,1562,1040,596,177,94176,65029,59621,5408,29147
15.021809,4.0717244,2011,E07000144,Broadland,124646,121795,1064,1265,331,191,90305,64232,59597,4635,26073
15.127872,4.678114,2011,E07000145,Great Yarmouth,97277,94215,1159,1204,439,260,70234,46018,40055,5963,24216
14.878901,3.5006828,2011,E07000146,King's Lynn and West Norfolk,147451,143409,1372,1863,561,246,106591,71704,65459,6245,34887
14.92589,4.6289396,2011,E07000147,North Norfolk,101499,100127,617,531,157,67,72453,45819,42147,3672,26634
15.429987,3.5828671,2011,E07000148,Norwich,132512,120375,3039,5844,2147,1107,100702,68772,58247,10525,31930
15.032389,4.0939994,2011,E07000149,South Norfolk,124012,120981,1214,1270,378,169,89337,63158,58512,4646,26179
14.640379,5.323081,2011,E07000150,Corby,61255,58519,836,782,1008,110,45049,33166,29686,3480,11883
14.871463,5.056866,2011,E07000151,Daventry,77843,75123,971,1183,481,85,57379,41546,38296,3250,15833
14.991915,4.906966,2011,E07000152,East Northamptonshire,86765,83842,1052,1096,630,145,63006,45821,42219,3602,17185
15.193205,4.7762628,2011,E07000153,Kettering,93475,87740,1313,3023,991,408,67920,50012,45524,4488,17908
14.823266,1.2789371,2011,E07000154,Northampton,212069,179238,6849,13751,10741,1490,155682,115479,101887,13592,40203
14.921765,4.919425,2011,E07000155,South Northamptonshire,85189,82572,1003,1129,376,109,62321,47449,44317,3132,14872
14.957579,5.079116,2011,E07000156,Wellingborough,75356,65788,2158,4463,2696,251,54817,39247,35256,3991,15570
14.375473,5.4106226,2011,E07000163,Craven,55409,53964,375,970,61,39,40056,28744,26704,2040,11312
14.937385,4.8589177,2011,E07000164,Hambleton,89140,87635,593,600,188,124,65255,47068,43959,3109,18187
14.792868,3.216797,2011,E07000165,Harrogate,157869,152075,1776,2409,1147,462,114038,84662,78711,5951,29376
14.356394,5.4444146,2011,E07000166,Richmondshire,51965,49556,502,1247,496,164,38652,29017,27166,1851,9635
14.274509,5.448196,2011,E07000167,Ryedale,51751,51064,302,273,80,32,37581,26644,24785,1859,10937
15.119391,4.4250307,2011,E07000168,Scarborough,108793,106104,869,1364,240,216,79393,52245,46482,5763,27148
14.914655,4.9449368,2011,E07000169,Selby,83449,82077,626,493,212,41,61831,45720,41990,3730,16111
15.095393,4.1500382,2011,E07000170,Ashfield,119497,116733,1059,1099,472,134,88037,59970,53931,6039,28067
15.124819,4.319531,2011,E07000171,Bassetlaw,112863,109892,996,1255,520,200,83305,56556,51284,5272,26749
15.368157,4.3733006,2011,E07000172,Broxtowe,109487,101538,1827,4503,933,686,81573,56838,51329,5509,24735
15.2372265,4.2494793,2011,E07000173,Gedling,113543,105656,2619,3343,1653,272,83284,59493,53867,5626,23791
15.126962,4.5014935,2011,E07000174,Mansfield,104466,101522,1106,1289,398,151,77155,52392,46961,5431,24763
15.104681,4.280491,2011,E07000175,Newark and Sherwood,114817,111958,1160,1036,499,164,84145,57971,52872,5099,26174
15.257089,4.3679695,2011,E07000176,Rushcliffe,111129,103504,1949,4614,627,435,80755,58045,53133,4912,22710
15.145351,3.567848,2011,E07000177,Cherwell,141868,130761,2560,6039,1961,547,103269,78160,72552,5608,25109
15.355803,2.6004567,2011,E07000178,Oxford,151906,117957,6035,18827,7028,2059,118437,74923,63453,11470,43514
14.982487,3.8106072,2011,E07000179,South Oxfordshire,134257,128993,1801,2405,768,290,96892,72820,68205,4615,24072
15.174323,4.1498036,2011,E07000180,Vale of White Horse,120988,114824,1574,2962,1230,398,87477,65710,61185,4525,21767
15.025202,4.5087314,2011,E07000181,West Oxfordshire,104779,101469,1263,1424,437,186,76163,58506,54940,3566,17657
15.041805,4.438858,2011,E07000187,Mendip,109279,107057,996,929,210,87,78653,56462,52172,4290,22191
15.066109,4.30741,2011,E07000188,Sedgemoor,114588,112724,869,735,140,120,82903,57966,52751,5215,24937
14.564394,3.1753523,2011,E07000189,South Somerset,161243,158130,1158,1409,357,189,115790,82390,76498,5892,33400
15.096631,4.4304433,2011,E07000190,Taunton Deane,110187,107116,1010,1608,286,167,78921,56832,52280,4552,22089
13.732311,5.588141,2011,E07000191,West Somerset,34675,34228,208,192,20,27,24918,16118,14985,1133,8800
15.081854,4.650546,2011,E07000192,Cannock Chase,97462,95256,867,982,280,77,72274,51306,46115,5191,20968
15.308409,4.3145494,2011,E07000193,East Staffordshire,113583,102704,1619,7864,1023,373,83059,58578,53144,5434,24481
15.0853,4.592289,2011,E07000194,Lichfield,100654,97399,1034,1623,481,117,74757,51862,47536,4326,22895
15.229557,4.0089173,2011,E07000195,Newcastle-under-Lyme,123871,117662,1490,3512,828,379,92335,61568,54599,6969,30767
15.160222,4.4036827,2011,E07000196,South Staffordshire,108131,103700,1495,2122,578,236,80718,56418,51671,4747,24300
15.229542,3.846028,2011,E07000197,Stafford,130869,124308,1694,3288,1107,472,97297,68274,61923,6351,29023
14.985966,4.672866,2011,E07000198,Staffordshire Moorlands,97106,95825,602,502,120,57,72085,49988,46130,3858,22097
14.893938,5.0690613,2011,E07000199,Tamworth,76813,74761,803,763,393,93,56833,41188,37120,4068,15645
14.949293,4.9050245,2011,E07000200,Babergh,87740,85845,827,666,264,138,63075,44347,41035,3312,18728
14.6358185,5.330598,2011,E07000201,Forest Heath,59748,54907,1744,1263,1296,538,44053,33115,30717,2398,10938
15.330726,3.5703576,2011,E07000202,Ipswich,133384,118596,4816,5740,3096,1136,97167,71423,63192,8231,25744
15.000116,4.7071466,2011,E07000203,Mid Suffolk,96731,94667,953,647,371,93,70073,50607,47096,3511,19466
15.160679,4.374445,2011,E07000204,St Edmundsbury,111008,106615,1404,1824,902,263,80968,59324,54760,4564,21644
15.077095,4.114282,2011,E07000205,Suffolk Coastal,124298,119976,1513,2032,556,221,88250,61006,56467,4539,27244
15.076183,4.3073354,2011,E07000206,Waveney,115254,112589,1215,959,369,122,81877,53460,47714,5746,28417
15.332052,3.8845031,2011,E07000207,Elmbridge,130875,118123,3411,7075,1010,1256,92027,67522,62942,4580,24505
15.069617,5.1242514,2011,E07000208,Epsom and Ewell,75102,64502,1922,6484,1128,1066,54170,39844,36449,3395,14326
15.599728,3.6105528,2011,E07000209,Guildford,137183,124707,2501,6616,1656,1703,102054,73649,65900,7749,28405
15.000343,4.962428,2011,E07000210,Mole Valley,85375,81168,1257,2177,399,374,60778,44170,41169,3001,16608
15.264468,3.6756086,2011,E07000211,Reigate and Banstead,137835,124879,3037,6992,2166,761,99173,74614,69231,5383,24559
15.170464,5.0039887,2011,E07000212,Runnymede,80510,71633,1671,5561,862,783,59793,42816,38321,4495,16977
15.305572,4.6883144,2011,E07000213,Spelthorne,95598,83455,2382,7295,1545,921,69916,52767,48765,4002,17149
15.128078,4.920866,2011,E07000214,Surrey Heath,86144,77692,1626,5389,861,576,62565,47016,43500,3516,15549
14.957798,4.97516,2011,E07000215,Tandridge,82998,77880,1789,2164,882,283,59457,43692,40722,2970,15765
15.160476,4.189713,2011,E07000216,Waverley,121572,116717,1623,2283,538,411,85617,61649,57117,4532,23968
15.368876,4.6178203,2011,E07000217,Woking,99198,82926,2335,11462,1383,1092,71722,54052,49576,4476,17670
14.576561,5.307525,2011,E07000218,North Warwickshire,62014,60709,506,580,172,47,46170,33151,30410,2741,13019
15.359451,4.014031,2011,E07000219,Nuneaton and Bedworth,125252,114392,1396,7880,1047,537,92090,65173,58292,6881,26917
15.240162,4.61373,2011,E07000220,Rugby,100075,90565,1986,5225,1987,312,72759,53457,49018,4439,19302
15.042071,4.155655,2011,E07000221,Stratford-on-Avon,120485,117307,1258,1466,264,190,87728,63253,58844,4409,24475
15.445114,3.6006978,2011,E07000222,Warwick,137648,122715,2803,9945,973,1212,102883,73309,66564,6745,29574
14.588498,5.3467064,2011,E07000223,Adur,61182,58663,886,1058,313,262,43860,31054,28482,2572,12806
14.884035,3.4871805,2011,E07000224,Arun,149518,145118,1502,2116,538,244,106071,71573,65185,6388,34498
15.150166,4.359985,2011,E07000225,Chichester,113794,110322,1092,1617,518,245,81037,56102,51005,5097,24935
15.435438,4.362423,2011,E07000226,Crawley,106597,85180,3098,13825,3469,1025,77348,59495,53637,5858,17853
15.050734,3.898823,2011,E07000227,Horsham,131301,126062,1774,2585,651,229,94318,69240,64165,5075,25078
14.996811,3.682634,2011,E07000228,Mid Sussex,139860,133018,1967,3761,788,326,100252,75025,69941,5084,25227
15.249509,4.550162,2011,E07000229,Worthing,104640,98136,1836,3372,869,427,74338,53630,48704,4926,20708
15.056541,4.7667074,2011,E07000234,Bromsgrove,93637,89696,1396,1925,444,176,67807,48664,44867,3797,19143
14.767769,5.1440196,2011,E07000235,Malvern Hills,74631,72841,639,902,151,98,53512,36261,33349,2912,17251
15.066458,4.9071503,2011,E07000236,Redditch,84214,77497,1655,4029,862,171,62523,46220,41464,4756,16303
15.219595,4.595198,2011,E07000237,Worcester,98768,92294,1395,4366,473,240,73382,53966,47532,6434,19416
15.063683,4.237339,2011,E07000238,Wychavon,116944,114457,962,1129,228,168,85481,61260,56459,4801,24221
15.0693035,4.653084,2011,E07000239,Wyre Forest,97975,95273,998,1390,214,100,72331,49712,45060,4652,22619
15.285031,3.5748148,2011,E07000240,St Albans,140664,124380,3904,9011,2388,981,99863,74553,69041,5512,25310
15.620161,4.2445674,2011,E07000241,Welwyn Hatfield,110535,92936,2797,8704,4989,1109,81514,57036,48850,8186,24478
15.010109,3.6879275,2011,E07000242,East Hertfordshire,137687,131456,2214,2681,984,352,100093,75434,70178,5256,24659
15.156622,4.910332,2011,E07000243,Stevenage,83957,73598,2265,4848,2836,410,60988,46140,41034,5106,14848
13.629363,0.49969444,2011,E08000001,Bolton,276786,226645,4892,38749,4652,1848,200723,134933,118777,16156,65790
15.050623,2.4016807,2011,E08000002,Bury,185060,165032,3365,13407,1893,1363,134687,94680,85291,9389,40007
1.8899739,-0.3682089,2011,E08000003,Manchester,503127,335109,23161,85986,43484,15387,382932,243224,194093,49131,139708
13.608219,1.2949531,2011,E08000004,Oldham,224897,174326,4057,43165,2797,552,159765,106398,93015,13383,53367
14.308901,1.6373891,2011,E08000005,Rochdale,211699,172874,3569,31630,2770,856,152742,101003,87821,13182,51739
14.568378,1.0649654,2011,E08000006,Salford,233933,210862,4616,9429,6541,2485,173117,118130,101014,17116,54987
12.910042,0.7982121,2011,E08000007,Stockport,283275,260819,5104,13762,1958,1632,205310,146296,132659,13637,59014
13.972949,1.6568373,2011,E08000008,Tameside,219324,199429,3159,14553,1784,399,161459,111016,98945,12071,50443
14.872719,1.2269806,2011,E08000009,Trafford,226578,193834,6031,17973,6540,2200,162806,118064,106854,11210,44742
11.035154,0.978646,2011,E08000010,Wigan,317849,309193,2756,3519,1678,703,236495,162781,145028,17753,73714
14.872253,3.4094093,2011,E08000011,Knowsley,145893,141858,1913,1403,505,214,106155,69617,59456,10161,36538
5.2509966,0.88799435,2011,E08000012,Liverpool,466415,414671,11756,19403,12308,8277,356876,226270,182270,44000,130606
14.341748,2.7060165,2011,E08000013,St. Helens,175308,171877,1179,1764,248,240,129584,86121,76158,9963,43463
12.24037,1.0651656,2011,E08000014,Sefton,273790,266741,2820,2719,796,714,198197,133012,117085,15927,65185
11.060779,0.9684368,2011,E08000015,Wirral,319783,310156,3286,5116,695,530,230851,153240,135543,17697,77611
13.117416,1.5663183,2011,E08000016,Barnsley,231221,226285,1630,1661,1221,424,170405,113306,100751,12555,57099
11.952712,0.8893598,2011,E08000017,Doncaster,302402,288066,3321,7614,2337,1064,220877,147770,130306,17464,73107
13.289141,1.1370159,2011,E08000018,Rotherham,257280,240758,2551,10551,2112,1308,187959,125899,111684,14215,62060
2.6393297,0.5415983,2011,E08000019,Sheffield,552698,462544,13289,44385,20082,12398,411004,270239,227822,42417,140765
13.233566,0.28098089,2011,E08000021,Newcastle upon Tyne,280177,239533,4279,27107,5160,4098,212864,133848,108778,25070,79016
13.997353,2.1044085,2011,E08000022,North Tyneside,200801,194025,1815,3815,734,412,147889,104242,92799,11443,43647
15.112902,3.3572423,2011,E08000023,South Tyneside,148127,142099,1325,3311,420,972,108981,72645,62266,10379,36336
12.096204,0.99613035,2011,E08000024,Sunderland,275506,264282,1778,7336,1273,837,205552,135467,116562,18905,70085
-0.32013872,0.03430251,2011,E08000025,Birmingham,1073045,621636,47605,285640,96360,21804,760252,488221,400679,87542,272031
14.519215,-0.9117951,2011,E08000026,Coventry,316960,234029,8230,51598,17764,5339,231871,153745,128764,24981,78126
12.764014,0.58632743,2011,E08000027,Dudley,312925,281607,5758,18942,4671,1947,226726,155530,137720,17810,71196
14.635429,-1.1350822,2011,E08000028,Sandwell,308063,215471,10199,59258,18357,4778,219508,146653,124338,22315,72855
14.724856,1.8757584,2011,E08000029,Solihull,206674,184244,4404,13561,3239,1226,148360,105108,94586,10522,43252
14.004484,0.26201734,2011,E08000030,Walsall,269323,212469,7224,41022,6369,2239,191974,126805,108668,18137,65169
14.791474,-0.85626143,2011,E08000031,Wolverhampton,249470,169682,12784,44960,17309,4735,179983,120402,99729,20673,59581
2.5916367,0.105530955,2011,E08000032,Bradford,522452,352317,12979,140149,9267,7740,366217,243727,210013,33714,122490
14.291801,1.9893136,2011,E08000033,Calderdale,203826,182787,2797,16875,899,468,148766,104893,93611,11282,43873
9.046782,0.58471745,2011,E08000034,Kirklees,422458,334270,9790,67782,7905,2711,307194,209514,184331,25183,97680
-0.18843527,0.0867988,2011,E08000035,Leeds,751485,639487,19632,58243,25893,8230,560849,389929,333333,56596,170920
11.207708,0.9533632,2011,E08000036,Wakefield,325837,310957,2928,8498,2512,942,240997,164768,148026,16742,76229
14.253746,2.11081,2011,E08000037,Gateshead,200214,192742,1558,3738,1081,1095,148079,100184,88817,11367,47895
12.744057,5.6370907,2011,E09000001,City of London,7375,5799,289,940,193,154,6307,4972,4641,331,1335
13.369343,0.5863484,2011,E09000002,Barking and Dagenham,185911,108386,7878,29594,37140,2913,127568,86404,71519,14885,41164
10.106709,-2.0847182,2011,E09000003,Barnet,356386,228553,17169,65918,27431,17315,258443,184483,163942,20541,73960
14.897408,0.8825441,2011,E09000004,Bexley,231997,189962,5395,15243,19624,1773,165914,118864,106286,12578,47050
8.270097,-2.1449354,2011,E09000005,Brent,311215,112880,15775,105986,58632,17942,233726,163991,139478,24513,69735
13.232725,-0.23874909,2011,E09000006,Bromley,309392,260870,10897,16067,18686,2872,222539,161282,147108,14174,61257
15.294488,-0.8999395,2011,E09000007,Camden,220338,146055,12322,35446,18060,8455,173833,118397,103986,14411,55436
7.1889915,-1.8632576,2011,E09000008,Croydon,363378,200195,23895,59627,73256,6405,263048,190308,165753,24555,72740
7.752741,-1.8591974,2011,E09000009,Ealing,338449,165818,15066,100439,36860,20266,252764,180615,157500,23115,72149
11.266436,-2.6279335,2011,E09000010,Enfield,312466,190640,17183,34893,53687,16063,224024,153334,131601,21733,70690
13.357587,-1.6945202,2011,E09000011,Greenwich,254557,159002,12274,29894,48655,4732,186722,132073,110846,21227,54649
11.675192,-2.4316685,2011,E09000012,Hackney,246270,134617,15869,25867,56858,13059,187423,133883,113367,20516,53540
14.094332,-0.084377564,2011,E09000013,Hammersmith and Fulham,182493,124222,10044,16635,21505,10087,145552,107754,95640,12114,37798
13.052328,-2.4853854,2011,E09000014,Haringey,254926,154343,16548,24150,47830,12055,193062,138189,118886,19303,54873
11.487232,-1.0632694,2011,E09000015,Harrow,239056,100991,9499,101808,19708,7050,174751,123307,109034,14273,51444
14.510745,1.1201682,2011,E09000016,Havering,237232,207949,4933,11545,11481,1324,171128,121642,109446,12196,49486
15.25642,-1.653912,2011,E09000017,Hillingdon,273936,166031,10479,69253,20082,8091,199926,141542,123188,18354,58384
13.23492,-1.492149,2011,E09000018,Hounslow,253957,130505,10349,87257,16813,9033,190157,137867,120742,17125,52290
14.752961,-0.73238593,2011,E09000019,Islington,206125,140515,13339,19034,26294,6943,165149,117488,102325,15163,47661
12.391596,0.8033578,2011,E09000020,Kensington and Chelsea,158649,112017,8986,15861,10333,11452,126080,87517,79198,8319,38563
15.411929,2.282735,2011,E09000021,Kingston upon Thames,160060,119219,6269,26152,4021,4399,119673,87348,77126,10222,32325
6.4033556,-1.6591291,2011,E09000022,Lambeth,303086,173025,23160,20938,78542,7421,237730,183190,159823,23367,54540
8.060497,-1.9316242,2011,E09000023,Lewisham,275885,147686,20472,25534,74942,7251,206255,151793,128905,22888,54462
15.172247,0.48369035,2011,E09000024,Merton,199693,129606,9334,36143,20811,3799,149598,112038,100904,11134,37560
6.9731503,-1.7483273,2011,E09000025,Newham,307984,89216,13945,133895,60256,10672,228958,153761,118862,34899,75197
10.777205,-1.6501477,2011,E09000026,Redbridge,278970,118646,11456,116503,24845,7520,199544,137776,119012,18764,61768
14.917787,1.948127,2011,E09000027,Richmond upon Thames,186990,160725,6780,13607,2816,3062,137779,104090,96185,7905,33689
8.573423,-2.120404,2011,E09000028,Southwark,288283,156349,17778,27192,77511,9453,224551,163859,139286,24573,60692
15.2581215,1.715119,2011,E09000029,Sutton,190146,149449,7134,22035,9120,2408,138710,103995,94432,9563,34715
11.117949,-1.3259202,2011,E09000030,Tower Hamlets,254096,114819,10360,104501,18629,5787,196552,137233,113219,24014,59319
14.981482,-2.6992188,2011,E09000031,Waltham Forest,258249,134799,13766,54389,44791,10504,190978,135015,114964,20051,55963
13.397989,-1.7613703,2011,E09000032,Wandsworth,306995,219216,15241,33338,32756,6444,243533,189789,172468,17321,53744
4.4472313,-0.7269835,2011,E09000033,Westminster,219396,135330,11395,31862,16472,24337,175505,120418,107531,12887,55087
14.735557,5.2088966,2011,W06000001,Isle of Anglesey,69751,68520,480,491,81,179,50818,33023,29423,3600,17795
15.292756,4.115204,2011,W06000002,Gwynedd,121874,117573,964,2170,289,878,88913,57995,51063,6932,30918
15.128695,4.3278933,2011,W06000003,Conwy,115228,112549,894,1252,199,334,81906,53792,48239,5553,28114
15.026736,4.776365,2011,W06000004,Denbighshire,93734,91254,751,1430,161,138,67676,44409,39788,4621,23267
14.710283,3.316398,2011,W06000005,Flintshire,152506,150161,851,1201,142,151,112325,78957,71539,7418,33368
15.071844,3.7777407,2011,W06000006,Wrexham,134844,130647,1010,2321,625,241,98691,68413,61123,7290,30278
14.913554,5.0581164,2011,W06000008,Ceredigion,75922,73443,736,1099,266,378,57405,35064,30031,5033,22341
15.041519,4.1406717,2011,W06000009,Pembrokeshire,122439,120121,733,1192,179,214,88049,58120,52601,5519,29929
14.149899,2.605221,2011,W06000010,Carmarthenshire,183777,180323,1033,1837,279,305,132930,86217,77956,8261,46713
13.733784,1.2767935,2011,W06000011,Swansea,239023,224697,2160,7803,1983,2380,176971,111460,96413,15047,65511
14.804376,3.6329825,2011,W06000012,Neath Port Talbot,139812,137087,910,1369,299,147,102986,64110,57220,6890,38876
14.9102745,3.649248,2011,W06000013,Bridgend,139178,136090,998,1549,315,226,102805,66449,59433,7016,36356
15.169281,3.9968457,2011,W06000014,Vale of Glamorgan,126336,121838,1695,1967,489,347,91816,63384,57143,6241,28432
12.554209,-0.16660544,2011,W06000015,Cardiff,346090,293114,10031,27885,8201,6859,260268,174753,147955,26798,85515
12.922094,1.5129498,2011,W06000016,Rhondda Cynon Taff,234410,228241,1506,3030,1308,325,172047,108730,95326,13404,63317
14.217892,2.6550245,2011,W06000018,Caerphilly,178806,175845,1174,1346,242,199,130950,84932,75354,9578,46018
14.726372,5.1740775,2011,W06000019,Blaenau Gwent,69814,68750,394,485,95,90,51809,32145,27516,4629,19664
15.004444,4.8200626,2011,W06000020,Torfaen,91075,89231,603,977,169,95,66107,43820,38965,4855,22287
14.980197,4.830903,2011,W06000021,Monmouthshire,91323,89526,624,900,144,129,66107,45272,41554,3718,20835
15.551033,3.4225667,2011,W06000022,Newport,145736,131025,2752,7986,2535,1438,105141,71011,61602,9409,34130
14.899939,3.878063,2011,W06000023,Powys,132976,130827,760,1142,132,115,96069,66846,61870,4976,29223
14.525582,5.353431,2011,W06000024,Merthyr Tydfil,58802,57391,462,696,143,110,43377,27833,24285,3548,15544
