x,y,year,geography code,geography,Ethnic Total,Asian,Black,Mixed,White,Other,Economic Total,Economically active,Economically active: In employment,Economically active: Unemployed,Economically inactive
-13.46303,10.748811,2021,E06000001,Hartlepool,92338,1600,445,671,89068,554,74685,40751,37749,3002,33934
-12.7295,11.623031,2021,E06000002,Middlesbrough,143922,15090,3816,3001,118547,3468,113939,62248,56433,5815,51691
-12.661976,11.34949,2021,E06000003,Redcar and Cleveland,136530,1160,265,1185,133388,532,112340,59624,55620,4004,52716
-11.393927,12.1608095,2021,E06000004,Stockton-on-Tees,196593,9052,2203,2737,180937,1664,158008,92342,86442,5900,65666
-13.282303,11.0526,2021,E06000005,Darlington,107796,2966,701,1472,101725,932,88103,52329,49296,3033,35774
-12.86929,11.286629,2021,E06000006,Halton,128478,1436,511,1791,123976,764,103948,62047,58706,3341,41901
-10.871628,12.214736,2021,E06000007,Warrington,210973,6954,1576,3335,197305,1803,172722,107975,103195,4780,64747
-11.631534,10.639727,2021,E06000008,Blackburn with Darwen,154741,55178,1406,2596,93392,2169,119509,68111,63558,4553,51398
-12.581284,11.481909,2021,E06000009,Blackpool,141039,3676,711,2210,133550,892,116338,64351,59361,4990,51987
-9.451966,12.6693125,2021,E06000010,"Kingston upon Hull, City of",267013,7515,5065,4513,244989,4931,213875,128155,117788,10367,85720
-7.6754136,12.561662,2021,E06000011,East Riding of Yorkshire,342215,3686,894,3197,333162,1276,288142,162798,156120,6678,125344
-12.27895,11.65576,2021,E06000012,North East Lincolnshire,156967,2437,846,1617,151030,1037,127521,73041,68850,4191,54480
-12.000564,11.8459215,2021,E06000013,North Lincolnshire,169684,5622,818,1820,160052,1372,139465,80446,76221,4225,59019
-11.037025,12.237023,2021,E06000014,York,202821,7634,1325,3741,188167,1954,172082,101232,96197,5035,70850
-9.694136,12.537681,2021,E06000015,Derby,261364,40901,10482,9562,192871,7548,209193,124347,116202,8145,84846
-5.2603755,7.4617887,2021,E06000016,Leicester,368571,159977,28766,13899,150657,15272,291012,169572,154932,14640,121440
-13.381741,9.573681,2021,E06000017,Rutland,41050,634,552,744,38909,211,34297,19425,18783,642,14872
-7.3864193,10.609012,2021,E06000018,Nottingham,323635,48217,32215,19063,213430,10710,264321,142935,128866,14069,121386
-11.363451,11.887305,2021,E06000019,"Herefordshire, County of",187032,2218,567,1980,181248,1019,157132,92163,88510,3653,64969
-11.605883,11.98935,2021,E06000020,Telford and Wrekin,185543,10067,5351,4844,163638,1643,148670,90380,85495,4885,58290
-10.09986,12.926854,2021,E06000021,Stoke-on-Trent,258369,25597,6884,5860,215699,4329,205899,119972,112580,7392,85927
-11.179522,11.9824095,2021,E06000022,Bath and North East Somerset,193409,6389,1846,5256,178308,1610,161616,94452,89810,4642,67164
-4.604754,9.1045885,2021,E06000023,"Bristol, City of",472467,31269,27890,21116,383142,9050,389708,252652,238510,14142,137056
-10.609287,12.09356,2021,E06000024,North Somerset,216729,3322,1139,3635,207429,1204,178567,106639,102702,3937,71928
-8.826022,12.641715,2021,E06000025,South Gloucestershire,290424,11094,4534,7289,264856,2651,237366,153466,147612,5854,83900
-9.600742,12.78891,2021,E06000026,Plymouth,264695,5947,2786,4656,248727,2579,218624,128144,121018,7126,90480
-12.578392,11.399568,2021,E06000027,Torbay,139324,2254,447,2084,133922,617,117030,62379,58935,3444,54651
-10.319284,12.36985,2021,E06000030,Swindon,233411,27173,6123,6495,190142,3478,187151,123902,117866,6036,63249
-10.813204,12.145273,2021,E06000031,Peterborough,215670,30801,8751,7617,162581,5920,167574,107102,100969,6133,60472
-8.8091755,9.952674,2021,E06000032,Luton,225261,83325,22735,9620,101798,7783,172695,107846,98718,9128,64849
-11.627092,11.924629,2021,E06000033,Southend-on-Sea,180685,9864,5153,5553,158079,2036,146410,88636,83259,5377,57774
-11.320597,11.351985,2021,E06000034,Thurrock,175993,12205,20877,5252,134984,2675,136364,91113,85948,5165,45251
-9.364193,12.798235,2021,E06000035,Medway,279773,16484,15723,7859,235747,3960,222755,140571,132604,7967,82184
-12.854372,11.20564,2021,E06000036,Bracknell Forest,124605,8879,2993,3843,107269,1621,99934,69400,66397,3003,30534
-12.007687,11.584929,2021,E06000037,West Berkshire,161447,5990,2030,3857,148384,1186,130737,85510,82308,3202,45227
-11.119883,11.296775,2021,E06000038,Reading,174223,30841,12532,8962,116886,5002,141357,94693,88864,5829,46664
-10.163414,9.594707,2021,E06000039,Slough,158500,74093,11992,6311,57134,8970,118933,79719,73699,6020,39214
-12.283762,11.575138,2021,E06000040,Windsor and Maidenhead,153497,20072,2358,5238,122551,3278,123676,80096,76302,3794,43580
-11.695505,11.747217,2021,E06000041,Wokingham,177502,22868,4306,5574,141851,2903,140821,93243,89467,3776,47578
-8.678846,11.779397,2021,E06000042,Milton Keynes,287060,35645,27851,11725,206114,5725,224835,151684,143379,8305,73151
-8.215151,11.821371,2021,E06000043,Brighton and Hove,277103,13217,5458,13228,236571,8629,235365,150125,139289,10836,85240
-10.943535,12.3403425,2021,E06000044,Portsmouth,208001,14370,7070,5487,177277,3797,170818,105376,97785,7591,65442
-9.900553,12.643544,2021,E06000045,Southampton,248920,26414,7539,8309,200829,5829,204369,126584,118228,8356,77785
-12.492153,11.374244,2021,E06000046,Isle of Wight,140459,1663,478,1720,136219,379,119584,61399,57909,3490,58185
-3.583886,8.196563,2021,E06000047,County Durham,522067,7834,1740,4949,505471,2073,433958,235484,222215,13269,198474
-6.6880546,12.55733,2021,E06000049,Cheshire East,398772,9531,2422,7059,376543,3217,329474,200289,192487,7802,129185
-7.547355,12.895692,2021,E06000050,Cheshire West and Chester,357149,7231,2107,5291,340361,2159,295358,177228,169088,8140,118130
-8.108396,12.721774,2021,E06000051,Shropshire,323607,4324,1117,3861,312876,1429,272245,158910,152422,6488,113335
-2.598765,6.2577133,2021,E06000052,Cornwall,570305,4032,1058,7030,552130,6055,477425,266622,254247,12375,210803
-12.622096,8.425605,2021,E06000053,Isles of Scilly,2055,6,4,23,2004,18,1729,1128,1113,15,601
-4.0778894,9.2136965,2021,E06000054,Wiltshire,510333,10876,5786,8709,481413,3549,419114,262075,252345,9730,157039
-11.141634,11.561816,2021,E06000055,Bedford,185224,23263,9848,8586,140174,3353,148118,95811,90865,4946,52307
-8.57707,12.380548,2021,E06000056,Central Bedfordshire,294251,10321,7018,8885,265545,2482,236760,157292,151077,6215,79468
-8.121497,12.594642,2021,E06000057,Northumberland,320566,3374,598,2557,313027,1010,268850,148602,140780,7822,120248
-6.65422,12.773911,2021,E06000058,"Bournemouth, Christchurch and Poole",400195,13551,4233,11093,365510,5808,334908,197215,186030,11185,137693
-6.8067265,12.194008,2021,E06000059,Dorset,379580,4305,1082,4436,368415,1342,321900,174681,167777,6904,147219
-3.3852248,7.6389203,2021,E06000060,Buckinghamshire,553078,68318,14269,19570,442164,8757,443394,285487,273235,12252,157907
-7.6018596,12.885371,2021,E06000061,North Northamptonshire,359523,12726,11017,8175,324664,2941,289187,186661,178857,7804,102526
-6.1781387,11.911039,2021,E06000062,West Northamptonshire,425723,22463,20661,12116,365758,4725,343503,226381,215996,10385,117122
-12.077698,11.302693,2021,E07000008,Cambridge,145674,21626,3561,7410,108570,4507,124765,74213,70598,3615,50552
-13.376284,10.588466,2021,E07000009,East Cambridgeshire,87763,1688,705,1883,82912,575,71429,46215,44695,1520,25214
-13.292732,10.914264,2021,E07000010,Fenland,102461,1232,814,1412,98280,723,84835,49392,47109,2283,35443
-11.513264,11.797132,2021,E07000011,Huntingdonshire,180832,5745,2646,4057,167116,1268,148261,94850,91391,3459,53411
-12.000267,11.559398,2021,E07000012,South Cambridgeshire,162117,9399,2019,4591,144285,1823,130361,85049,82267,2782,45312
-13.284793,10.729207,2021,E07000026,Allerdale,96153,540,84,627,94667,235,80510,46015,44235,1780,34495
-13.528506,10.222312,2021,E07000027,Barrow-in-Furness,67406,949,250,550,65412,245,55834,32692,31183,1509,23142
-13.141587,11.006486,2021,E07000028,Carlisle,110025,1628,337,973,106508,579,91343,55272,52950,2322,36071
-13.50758,10.198584,2021,E07000029,Copeland,67076,547,185,450,65714,180,56009,31946,30571,1375,24063
-13.45223,9.910103,2021,E07000030,Eden,54737,435,87,368,53699,148,46635,28183,27335,848,18452
-13.115999,10.850198,2021,E07000031,South Lakeland,104450,812,251,1034,102025,328,89703,51636,50137,1499,38067
-12.797885,11.183534,2021,E07000032,Amber Valley,126204,1208,381,1548,122767,300,105066,62625,60171,2454,42441
-13.45296,10.460305,2021,E07000033,Bolsover,80270,722,419,744,78143,242,66278,39653,38100,1553,26625
-13.264976,10.920376,2021,E07000034,Chesterfield,103568,1950,839,1498,98857,424,86004,49883,47532,2351,36121
-13.463499,10.277882,2021,E07000035,Derbyshire Dales,71535,518,169,723,69940,185,61061,34373,33229,1144,26688
-13.07607,11.046239,2021,E07000036,Erewash,112908,1788,871,2048,107769,432,93526,57478,54966,2512,36048
-13.347907,10.663945,2021,E07000037,High Peak,90935,694,223,1185,88614,219,75662,46481,44616,1865,29181
-13.218362,10.828696,2021,E07000038,North East Derbyshire,102003,952,324,1170,99367,190,85275,48471,46564,1907,36804
-13.190212,10.939864,2021,E07000039,South Derbyshire,107206,3841,855,1934,99836,740,86956,55907,53907,2000,31049
-12.217228,11.416636,2021,E07000040,East Devon,150823,1459,348,1720,146847,449,127388,69189,66727,2462,58199
-12.836139,11.444228,2021,E07000041,Exeter,130707,6375,1137,3308,118034,1853,111331,63256,59701,3555,48075
-13.400204,10.476335,2021,E07000042,Mid Devon,82853,562,101,899,81068,223,68203,41654,40279,1375,26549
-13.291296,10.800149,2021,E07000043,North Devon,98612,1135,325,1174,95639,339,82194,47138,45166,1972,35056
-13.3623905,10.603776,2021,E07000044,South Hams,88628,614,149,1048,86427,390,74968,42013,40585,1428,32955
-12.595793,11.269116,2021,E07000045,Teignbridge,134802,1004,216,1564,131668,350,113461,64536,62137,2399,48925
-13.498293,10.216912,2021,E07000046,Torridge,68114,356,75,630,66920,133,57560,31418,30054,1364,26142
-13.4762,9.958953,2021,E07000047,West Devon,57094,337,122,626,55847,162,48362,26317,25384,933,22045
-13.372795,10.984004,2021,E07000061,Eastbourne,101680,3544,1308,2802,92342,1684,84573,46757,43831,2926,37816
-13.485258,10.7915,2021,E07000062,Hastings,90995,2536,1262,2639,83191,1367,74702,43772,40897,2875,30930
-13.305812,10.8591175,2021,E07000063,Lewes,99909,1899,722,2461,94101,726,83221,46800,44506,2294,36421
-13.352009,10.710633,2021,E07000064,Rother,93114,1390,561,1702,88993,468,79489,39914,37934,1980,39575
-12.037749,11.581569,2021,E07000065,Wealden,160152,2250,646,2709,153809,738,133648,77504,74543,2961,56144
-11.498232,11.944704,2021,E07000066,Basildon,187567,7995,8913,4938,164116,1605,148662,93971,89010,4961,54691
-12.193485,11.573525,2021,E07000067,Braintree,155265,2566,1889,3014,146981,815,126567,79834,76282,3552,46733
-13.520787,10.446302,2021,E07000068,Brentwood,77048,3913,1747,2368,68194,826,62866,39506,37900,1606,23360
-13.424988,10.676536,2021,E07000069,Castle Point,89582,1550,1179,1446,84981,426,74405,42904,41002,1902,31501
-11.604556,11.900857,2021,E07000070,Chelmsford,181523,9646,4756,4724,160701,1696,147737,93844,89861,3983,53893
-11.362732,12.113097,2021,E07000071,Colchester,192716,9907,6661,5602,167701,2845,156342,97495,92015,5480,58847
-12.717749,11.432012,2021,E07000072,Epping Forest,134980,9678,3932,4896,113469,3005,109932,69230,65796,3434,40702
-13.429767,10.79719,2021,E07000073,Harlow,93330,5555,5827,3048,77214,1686,73102,48826,45981,2845,24276
-13.510754,10.190042,2021,E07000074,Maldon,66211,741,236,897,64129,208,55426,32581,31254,1327,22845
-13.433807,10.584985,2021,E07000075,Rochford,85662,1185,633,1432,82116,296,70713,42485,40661,1824,28228
-12.312073,11.434499,2021,E07000076,Tendring,148293,1794,910,2393,142656,540,124890,62132,58280,3852,62758
-13.359949,10.654643,2021,E07000077,Uttlesford,91344,1722,709,2016,86296,601,73519,47470,45740,1730,26049
-13.018393,11.189031,2021,E07000078,Cheltenham,118836,4922,1181,2949,108559,1225,98436,61873,59157,2716,36563
-13.344075,10.657033,2021,E07000079,Cotswold,90830,1195,402,1393,87510,330,76315,45652,44079,1573,30663
-13.4135895,10.608874,2021,E07000080,Forest of Dean,87004,625,242,925,84869,343,73046,41777,39989,1788,31269
-12.67416,11.289235,2021,E07000081,Gloucester,132414,8543,4826,5014,112461,1570,106939,68956,65621,3335,37983
-12.865728,11.090842,2021,E07000082,Stroud,121104,1256,528,2171,116701,448,100197,62038,59919,2119,38159
-13.324507,10.717042,2021,E07000083,Tewkesbury,94882,1924,595,1699,90206,458,77353,48226,46524,1702,29127
-11.419408,11.865546,2021,E07000084,Basingstoke and Deane,185154,10967,3611,4717,163840,2019,149807,101108,96973,4135,48699
-12.832649,11.19899,2021,E07000085,East Hampshire,125742,2370,658,2079,119993,642,103829,64115,61732,2383,39714
-12.633725,11.334146,2021,E07000086,Eastleigh,136444,5256,1300,2817,126083,988,110330,72212,69514,2698,38118
-13.032661,11.045499,2021,E07000087,Fareham,114512,2114,670,1727,109499,502,95636,57693,55629,2064,37943
-13.505716,10.554999,2021,E07000088,Gosport,81949,1169,984,1210,78136,450,67213,40568,38486,2082,26645
-13.291141,10.817174,2021,E07000089,Hart,99404,3595,843,2231,91952,783,80326,52411,50444,1967,27915
-12.925085,11.228705,2021,E07000090,Havant,124210,2107,750,1719,119127,507,102866,59350,56369,2981,43516
-11.609301,11.703545,2021,E07000091,New Forest,175782,2103,703,2215,170118,643,148742,81777,78700,3077,66965
-13.39368,10.947093,2021,E07000092,Rushmoor,99759,14658,2531,2578,77219,2773,80872,55548,53017,2531,25324
-12.765619,11.273476,2021,E07000093,Test Valley,130491,4284,1458,2312,121457,980,106753,68171,65862,2309,38582
-12.859301,11.264047,2021,E07000094,Winchester,127444,3917,792,2590,119305,840,104750,63289,60573,2716,41461
-13.27407,10.89153,2021,E07000095,Broxbourne,99007,3657,6588,3930,80301,4531,79437,50969,48306,2663,28468
-12.185427,11.534342,2021,E07000096,Dacorum,155081,8948,4411,5266,134602,1854,123783,80791,77199,3592,42992
-13.25058,11.063043,2021,E07000098,Hertsmere,107827,11320,5181,4038,83145,4143,86193,55526,52767,2759,30667
-12.613649,11.2476015,2021,E07000099,North Hertfordshire,133210,6956,3235,4913,116620,1486,107743,70011,67162,2849,37732
-13.4063015,10.741129,2021,E07000102,Three Rivers,93772,14265,2233,3390,72316,1568,75002,49093,46947,2146,25909
-13.057396,10.738877,2021,E07000103,Watford,102245,25037,6488,4844,62228,3648,80963,55941,52859,3082,25022
-12.902266,11.44666,2021,E07000105,Ashford,132747,7668,3424,2877,116896,1882,106770,66680,63616,3064,40090
-12.193846,11.755099,2021,E07000106,Canterbury,157429,6377,3906,4316,140473,2357,132778,71404,66169,5235,61374
-12.938799,11.021539,2021,E07000107,Dartford,116754,11513,12282,3638,86936,2385,90698,61827,58823,3004,28871
-13.130234,11.170726,2021,E07000108,Dover,116411,2402,837,1754,110419,999,96135,53982,50929,3053,42153
-13.382613,11.116101,2021,E07000109,Gravesham,106902,11999,6952,2828,81893,3230,84556,53012,49761,3251,31544
-11.822607,11.894916,2021,E07000110,Maidstone,175781,8213,3606,4013,157864,2085,142136,90263,86409,3854,51873
-12.989101,11.121213,2021,E07000111,Sevenoaks,120515,3484,1932,3181,111005,913,96603,58728,56384,2344,37875
-13.250401,11.090945,2021,E07000112,Folkestone and Hythe,109759,4271,682,2108,101614,1084,91555,50765,47819,2946,40790
-12.395554,11.592424,2021,E07000113,Swale,151677,2312,3487,2741,142341,796,121998,73117,69201,3916,48881
-12.636289,11.497286,2021,E07000114,Thanet,140587,3259,1481,3420,130719,1708,115413,63337,59189,4148,52076
-12.740232,11.252969,2021,E07000115,Tonbridge and Malling,132201,3876,1314,2943,123287,781,105526,66991,64426,2565,38535
-13.094988,11.074729,2021,E07000116,Tunbridge Wells,115314,4566,1131,2949,105562,1106,92402,58284,55898,2386,34118
-13.520131,10.784888,2021,E07000117,Burnley,94651,13930,326,1505,78112,778,75200,42735,40035,2700,32465
-12.999014,11.083495,2021,E07000118,Chorley,117733,2204,653,1773,112588,515,96370,59510,57244,2266,36860
-13.464325,10.509463,2021,E07000119,Fylde,81375,1173,331,1158,78332,381,69251,37339,35718,1621,31912
-13.592161,10.542267,2021,E07000120,Hyndburn,82237,12401,224,1091,67984,537,65631,37843,35627,2216,27788
-12.61019,11.543643,2021,E07000121,Lancaster,142939,5155,1215,2204,133063,1302,119638,65780,62399,3381,53858
-13.3731785,10.620454,2021,E07000122,Pendle,95758,25573,244,1488,67577,876,75224,42012,39625,2387,33212
-12.464729,11.47985,2021,E07000123,Preston,147834,29815,3489,4367,107321,2842,118670,71191,66634,4557,47479
-13.469227,10.049863,2021,E07000124,Ribble Valley,61565,1265,125,736,59256,183,51465,31251,30385,866,20214
-13.551673,10.291309,2021,E07000125,Rossendale,70868,3876,172,1043,65510,267,57301,34680,33118,1562,22621
-13.080469,10.970166,2021,E07000126,South Ribble,111035,2307,539,1908,105919,362,91498,56754,54709,2045,34744
-13.024061,11.139843,2021,E07000127,West Lancashire,117429,1232,388,1547,113795,467,98334,56523,53547,2976,41811
-13.0892935,11.002901,2021,E07000128,Wyre,111946,1109,273,1135,109139,290,94352,50307,47835,2472,44045
-13.313379,10.927948,2021,E07000129,Blaby,102924,8497,1594,2765,88753,1315,83666,53511,51446,2065,30155
-11.617201,11.983959,2021,E07000130,Charnwood,183970,22853,2840,4660,151459,2158,153100,89169,84799,4370,63931
-13.315043,10.784608,2021,E07000131,Harborough,97623,5298,699,2003,88851,772,80427,50315,48770,1545,30112
-13.067052,11.036695,2021,E07000132,Hinckley and Bosworth,113641,3147,692,1990,107180,632,93916,57944,55885,2059,35972
-13.456396,9.839482,2021,E07000133,Melton,51752,599,192,659,50142,160,42948,26369,25468,901,16579
-13.193086,10.895759,2021,E07000134,North West Leicestershire,104707,1543,642,1592,100449,481,86165,54001,51961,2040,32164
-13.596269,10.03592,2021,E07000135,Oadby and Wigston,57747,16131,1254,1873,36592,1897,47210,27441,25989,1452,19769
-13.570518,10.328672,2021,E07000136,Boston,70505,1443,467,1015,66733,847,57584,35260,33631,1629,22324
-12.391344,11.321731,2021,E07000137,East Lindsey,142295,1134,292,1484,139100,285,121420,59088,55579,3509,62332
-13.339056,11.066405,2021,E07000138,Lincoln,103814,3347,1466,2068,95665,1268,87064,50590,46715,3875,36474
-12.951603,11.064822,2021,E07000139,North Kesteven,118072,1160,416,1368,114729,399,98017,58978,56894,2084,39039
-13.353731,10.771596,2021,E07000140,South Holland,95122,1176,517,1225,91623,581,78998,47209,45234,1975,31789
-12.49749,11.440374,2021,E07000141,South Kesteven,143405,2529,875,1951,137421,629,118011,71185,68195,2990,46826
-13.349802,10.747403,2021,E07000142,West Lindsey,95153,1136,333,1081,92261,342,79120,44159,42138,2021,34961
-12.52215,11.418483,2021,E07000143,Breckland,141477,1340,820,2051,136457,809,117855,68440,65638,2802,49415
-12.681209,11.252938,2021,E07000144,Broadland,131723,1831,684,1842,126869,497,110505,64827,62589,2238,45678
-13.379507,10.922943,2021,E07000145,Great Yarmouth,99750,1936,1104,1575,94361,774,82719,44475,41139,3336,38244
-12.270639,11.597629,2021,E07000146,King's Lynn and West Norfolk,154326,2886,843,2022,147563,1012,128888,72399,69220,3179,56489
-13.15024,10.814363,2021,E07000147,North Norfolk,102978,565,183,978,101007,245,89143,43616,41657,1959,45527
-12.486879,11.62019,2021,E07000148,Norwich,143924,7867,3578,4519,125421,2539,120763,71055,65720,5335,49708
-12.494779,11.374354,2021,E07000149,South Norfolk,141948,2562,1164,2094,135474,654,117219,70090,67749,2341,47129
-13.464724,9.952083,2021,E07000163,Craven,56927,972,87,569,55143,156,48283,27943,27131,812,20340
-13.310448,10.624129,2021,E07000164,Hambleton,90692,664,244,741,88764,279,76985,44737,43405,1332,32248
-11.955351,11.585752,2021,E07000165,Harrogate,162668,2947,1036,2573,155244,868,135306,82286,79686,2600,53020
-13.477341,9.823271,2021,E07000166,Richmondshire,49781,1346,440,462,46989,544,41736,25526,24675,851,16210
-13.45406,9.89955,2021,E07000167,Ryedale,54707,325,93,424,53701,164,46325,26772,25961,811,19553
-13.161643,10.9831085,2021,E07000168,Scarborough,108736,1372,331,1069,105460,504,92109,48974,46549,2425,43135
-13.325176,10.656568,2021,E07000169,Selby,91988,694,228,884,89854,328,75430,47832,46121,1711,27598
-12.902215,11.258596,2021,E07000170,Ashfield,126299,1968,1575,2059,120147,550,102843,61531,58427,3104,41312
-13.020212,11.109387,2021,E07000171,Bassetlaw,117803,1455,736,1405,113620,587,97370,57282,54920,2362,40088
-13.224733,11.116925,2021,E07000172,Broxtowe,110940,6152,1867,2819,98636,1466,92538,54415,51915,2500,38123
-12.96686,11.077634,2021,E07000173,Gedling,117264,4532,2675,4130,104918,1009,96462,58689,56186,2503,37773
-13.206495,11.050014,2021,E07000174,Mansfield,110482,2234,1174,1544,104712,818,90170,53882,51367,2515,36288
-12.907802,11.171512,2021,E07000175,Newark and Sherwood,122959,1411,804,1844,118366,534,101968,59562,57114,2448,42406
-13.000702,11.116028,2021,E07000176,Rushcliffe,119077,6775,1095,3303,106827,1077,97724,59116,56978,2138,38608
-11.992983,11.589459,2021,E07000177,Cherwell,161015,9706,2845,4614,141831,2019,130586,88197,84970,3227,42389
-11.49685,11.274077,2021,E07000178,Oxford,162040,24991,7535,9005,114561,5948,136718,77669,73326,4343,59049
-12.280127,11.437837,2021,E07000179,South Oxfordshire,149088,4263,1467,3402,138785,1171,121491,79136,76476,2660,42355
-12.576142,11.363893,2021,E07000180,Vale of White Horse,138913,5490,2315,3452,126104,1552,112425,73280,70863,2417,39145
-12.986274,10.994105,2021,E07000181,West Oxfordshire,114236,1936,722,2141,108773,664,93810,60809,58926,1883,33001
-13.000108,11.048037,2021,E07000187,Mendip,116089,1298,369,1666,112351,405,96052,57860,55671,2189,38192
-12.869326,11.209664,2021,E07000188,Sedgemoor,125341,1806,423,1431,121085,596,103782,61679,59148,2531,42103
-11.738056,11.706019,2021,E07000189,South Somerset,172670,2330,816,2023,166829,672,143817,84072,80935,3137,59745
-13.274048,10.85489,2021,E07000192,Cannock Chase,100523,1208,472,1422,97131,290,82478,51378,48877,2501,31100
-13.042742,11.281159,2021,E07000193,East Staffordshire,124021,11552,1376,2723,107051,1319,100507,62173,59316,2857,38334
-13.188826,10.941499,2021,E07000194,Lichfield,106436,2496,601,1987,100917,435,88597,52639,50473,2166,35958
-12.992516,11.281042,2021,E07000195,Newcastle-under-Lyme,123299,4642,1289,1988,114523,857,103184,59643,56683,2960,43541
-13.134304,11.024579,2021,E07000196,South Staffordshire,110475,3108,1031,2242,103570,524,93372,52966,50699,2267,40406
-12.652481,11.387904,2021,E07000197,Stafford,136870,4165,1440,2552,127805,908,113614,68385,65765,2620,45229
-13.265762,10.715711,2021,E07000198,Staffordshire Moorlands,95844,658,188,902,93931,165,80856,46650,45037,1613,34206
-13.498243,10.465807,2021,E07000199,Tamworth,78642,1081,492,1472,75309,288,63793,40229,38161,2068,23564
-13.360023,10.705117,2021,E07000200,Babergh,92342,875,503,1351,89269,344,77378,44824,42956,1868,32554
-12.415718,11.318872,2021,E07000202,Ipswich,139643,7611,4882,6409,117757,2984,111832,71116,67026,4090,40716
-13.186062,10.848291,2021,E07000203,Mid Suffolk,102701,821,553,1463,99463,401,86305,51759,50024,1735,34546
-12.525141,11.271684,2021,E07000207,Elmbridge,138755,9052,1730,5688,119500,2785,108774,70000,66980,3020,38774
-13.509621,10.520706,2021,E07000208,Epsom and Ewell,80937,9233,1569,3550,64312,2273,64607,41717,39910,1807,22890
-12.550947,11.58808,2021,E07000209,Guildford,143647,9630,2150,4386,124788,2693,119356,73429,69774,3655,45927
-13.431305,10.633283,2021,E07000210,Mole Valley,87387,2637,706,2194,81046,804,72339,44028,42342,1686,28311
-12.278793,11.468219,2021,E07000211,Reigate and Banstead,150846,11383,4415,5541,127334,2173,120127,78471,75124,3347,41656
-13.518951,10.750466,2021,E07000212,Runnymede,88079,8140,1591,3113,73557,1678,72719,45103,42456,2647,27616
-13.33017,10.987,2021,E07000213,Spelthorne,102960,13146,2548,3763,81000,2503,83363,54555,51540,3015,28808
-13.494681,10.762679,2021,E07000214,Surrey Heath,90456,8057,1428,2460,76901,1610,73785,47447,45364,2083,26338
-13.384422,10.595951,2021,E07000215,Tandridge,87877,3271,1929,3331,78584,762,70827,44452,42576,1876,26375
-12.823727,11.211847,2021,E07000216,Waverley,128226,3625,887,2846,120088,780,103639,63121,60725,2396,40518
-13.293302,10.932397,2021,E07000217,Woking,103943,14741,1879,3614,81529,2180,82984,55238,52744,2494,27746
-13.519073,10.174823,2021,E07000218,North Warwickshire,65036,844,364,1113,62514,201,53898,33210,31754,1456,20688
-12.906776,11.489418,2021,E07000219,Nuneaton and Bedworth,134198,10782,2446,2449,116939,1582,108590,66590,63115,3475,42000
-13.115037,11.084891,2021,E07000220,Rugby,114363,8728,3110,3202,98013,1310,92188,60387,58107,2280,31801
-12.608395,11.293084,2021,E07000221,Stratford-on-Avon,134724,2566,482,2288,128672,716,112639,68512,66236,2276,44127
-12.427746,11.595439,2021,E07000222,Warwick,148454,14403,1616,4479,125534,2422,123254,76199,72748,3451,47055
-13.561056,10.184787,2021,E07000223,Adur,64543,1395,530,1627,60294,697,52954,31271,29825,1446,21683
-11.954924,11.704509,2021,E07000224,Arun,164887,2630,857,2484,158002,914,139553,76832,73190,3642,62721
-12.898964,11.230779,2021,E07000225,Chichester,124071,2168,783,2047,118404,669,104709,59081,56365,2716,45628
-12.953701,11.137704,2021,E07000226,Crawley,118492,18236,5331,4838,86939,3148,93567,63548,58899,4649,30019
-12.387487,11.467101,2021,E07000227,Horsham,146776,3974,1312,3130,137442,918,120663,75077,72167,2910,45586
-12.227923,11.479745,2021,E07000228,Mid Sussex,152566,5505,1337,3827,140724,1173,123317,79510,76573,2937,43807
-13.170416,11.094274,2021,E07000229,Worthing,111338,4387,1281,2854,101709,1107,92355,56302,53557,2745,36053
-13.296701,10.810496,2021,E07000234,Bromsgrove,99183,3159,766,2414,92309,535,81102,49278,47288,1990,31824
-13.46734,10.461835,2021,E07000235,Malvern Hills,79487,1051,262,1119,76779,276,67122,37354,35802,1552,29768
-13.467451,10.636101,2021,E07000236,Redditch,87034,4995,1054,2283,78173,529,70250,44849,42692,2157,25401
-13.317674,11.01088,2021,E07000237,Worcester,103869,5860,1212,2283,93478,1036,85605,54601,51627,2974,31004
-12.677053,11.277514,2021,E07000238,Wychavon,132495,1510,461,1600,128325,599,110717,66063,63660,2403,44654
-13.291716,10.888661,2021,E07000239,Wyre Forest,101609,1939,395,1470,97423,382,84565,48237,45789,2448,36328
-12.243575,11.301719,2021,E07000240,St Albans,148169,12176,3159,6354,123865,2615,116090,75854,72870,2984,40236
-12.955657,11.211894,2021,E07000241,Welwyn Hatfield,119835,10595,7307,4931,94298,2704,97484,61950,58149,3801,35534
-12.235508,11.437105,2021,E07000242,East Hertfordshire,150159,4019,1951,4245,138587,1357,121151,79595,76526,3069,41556
-13.423316,10.688402,2021,E07000243,Stevenage,89498,6700,4340,3216,74099,1143,71239,47817,45463,2354,23422
-9.84701,12.337827,2021,E07000244,East Suffolk,246060,3447,1357,3707,236627,922,206721,111807,106367,5440,94914
-11.542836,11.838277,2021,E07000245,West Suffolk,179948,4731,2873,4880,165156,2308,148130,93203,89622,3581,54927
-12.157757,11.591328,2021,E07000246,Somerset West and Taunton,157447,3224,827,2019,150583,794,131294,76213,73293,2920,55081
-9.037718,12.602525,2021,E08000001,Bolton,295960,59596,11238,6643,212941,5542,232293,134542,125439,9103,97751
-11.52802,12.17021,2021,E08000002,Bury,193851,20593,3690,5123,160716,3729,154871,93461,88481,4980,61410
-2.2044063,3.0470188,2021,E08000003,Manchester,551938,115109,65893,29026,313632,28278,437958,259288,234284,25004,178670
-9.779137,11.613555,2021,E08000004,Oldham,242087,59565,8209,6125,164897,3291,187035,105966,98206,7760,81069
-10.726224,12.183141,2021,E08000005,Rochdale,223771,41406,7927,5284,165485,3669,174947,101069,94459,6610,73878
-9.351374,12.586083,2021,E08000006,Salford,269922,14938,16473,8501,222248,7762,216921,137780,127605,10175,79141
-9.074838,13.084849,2021,E08000007,Stockport,294770,21464,3416,7668,257530,4692,238927,146544,139806,6738,92383
-10.565445,12.499094,2021,E08000008,Tameside,231070,21198,5275,4963,197676,1958,185136,112079,105655,6424,73057
-10.25662,12.2574,2021,E08000009,Trafford,235053,29588,8086,8834,182761,5784,186150,117117,111557,5560,69033
-8.208156,12.993171,2021,E08000010,Wigan,329330,5826,3907,4353,312952,2292,268694,162896,154614,8282,105798
-12.304461,11.608194,2021,E08000011,Knowsley,154518,2510,1264,2658,147234,852,124297,73881,69490,4391,50416
-4.1783004,8.624292,2021,E08000012,Liverpool,486088,27767,16964,16880,408443,16034,403028,224956,205750,19206,178072
-11.565258,11.9130745,2021,E08000013,St. Helens,183248,2579,776,1971,176888,1034,150572,87330,82624,4706,63242
-9.181023,12.744109,2021,E08000014,Sefton,279233,4294,1509,4056,267540,1834,232389,131658,124596,7062,100731
-8.379938,12.913737,2021,E08000015,Wirral,320199,7302,1389,4930,304692,1886,262111,147023,139503,7520,115088
-10.022594,12.41488,2021,E08000016,Barnsley,244572,2297,1715,2293,236934,1333,199792,117520,111680,5840,82272
-8.822348,13.196984,2021,E08000017,Doncaster,308104,9086,3742,4603,286955,3718,250926,146264,137859,8405,104662
-9.807734,12.911524,2021,E08000018,Rotherham,265806,14176,3016,3854,241954,2806,215571,124654,117801,6853,90917
-3.1173022,6.6018806,2021,E08000019,Sheffield,556523,53560,25512,19704,440216,17531,456247,260057,242006,18051,196190
-8.83814,12.98513,2021,E08000021,Newcastle upon Tyne,300127,34128,9921,6920,240002,9156,248447,136892,125075,11817,111555
-10.906033,12.19057,2021,E08000022,North Tyneside,208968,5396,1281,2879,198208,1204,171513,102868,97266,5602,68645
-12.459663,11.586204,2021,E08000023,South Tyneside,147777,4317,786,1995,139483,1196,121291,67794,62508,5286,53497
-9.2683115,12.63226,2021,E08000024,Sunderland,274173,8204,2665,2505,259375,1424,226074,125948,117154,8794,100126
-0.07796254,0.02966831,2021,E08000025,Birmingham,1144922,355384,125760,55205,556608,51965,889622,494724,442417,52307,394898
-8.214966,12.286686,2021,E08000026,Coventry,345321,63915,30723,11731,226246,12706,276871,163686,150141,13545,113185
-8.520102,13.32265,2021,E08000027,Dudley,323488,27047,8170,9191,274596,4484,262488,154502,144640,9862,107986
-7.877806,11.2346735,2021,E08000028,Sandwell,341832,88024,29779,14680,195624,13725,266026,155194,141070,14124,110832
-10.7015295,12.148908,2021,E08000029,Solihull,216240,23845,3955,7496,177668,3276,174501,103460,97939,5521,71041
-9.121239,12.402318,2021,E08000030,Walsall,284126,53199,13024,9317,202724,5862,223097,128492,118530,9962,94605
-8.692588,11.067571,2021,E08000031,Wolverhampton,263726,55901,24636,14065,159707,9417,208444,122990,111311,11679,85454
-2.3712924,4.7869487,2021,E08000032,Bradford,546412,175664,10978,15006,334004,10760,421574,239279,221136,18143,182295
-11.119642,12.184747,2021,E08000033,Calderdale,206631,21726,1439,4027,177836,1603,166634,98755,93382,5373,67879
-6.172377,11.866472,2021,E08000034,Kirklees,433213,84202,9948,13588,318969,6506,346271,202190,190084,12106,144081
-0.15585603,0.22496435,2021,E08000035,Leeds,811953,78503,45376,27388,641801,18885,658470,401119,374063,27056,257351
-7.858137,13.174907,2021,E08000036,Wakefield,353370,12633,4516,4938,328742,2541,287538,173152,164641,8511,114386
-11.36329,12.254588,2021,E08000037,Gateshead,196149,4925,2214,2393,183489,3128,161749,93515,87519,5996,68234
-12.869553,8.70093,2021,E09000001,City of London,8584,1445,232,470,5955,482,8004,5678,5351,327,2326
-8.119403,8.918148,2021,E09000002,Barking and Dagenham,218871,56583,46807,9320,98275,7886,161746,103667,94591,9076,58079
-4.892877,6.489863,2021,E09000003,Barnet,389344,74972,30651,20889,224762,38070,309355,199761,186176,13585,109594
-9.467472,11.601451,2021,E09000004,Bexley,246475,24434,30075,8740,177164,6062,195827,125346,117983,7363,70481
-6.0996504,7.219314,2021,E09000005,Brent,339821,111515,59495,17249,117701,33861,275142,175982,160998,14984,99160
-7.481364,11.389476,2021,E09000006,Bromley,329991,27307,25149,17740,252295,7500,265088,171090,162122,8968,93998
-9.170963,10.549544,2021,E09000007,Camden,210136,38042,18892,13938,125064,14200,177908,111524,102511,9013,66384
-4.712338,5.671314,2021,E09000008,Croydon,390724,68487,88441,29745,188985,15066,310396,204136,189405,14731,106260
-5.0500736,6.27137,2021,E09000009,Ealing,367116,111241,39491,19161,158463,38760,295371,190291,175026,15265,105080
-4.9092197,5.6908984,2021,E09000010,Enfield,329985,37973,60512,19558,171884,40058,257182,156015,143864,12151,101167
-7.0031524,8.702701,2021,E09000011,Greenwich,289065,38028,60602,17297,161006,12132,229749,155202,142935,12267,74547
-7.1504707,8.410729,2021,E09000012,Hackney,259147,26885,54645,17487,137709,22421,209466,145767,134308,11459,63699
-9.500127,10.241769,2021,E09000013,Hammersmith and Fulham,183156,19306,22453,12318,115679,13400,154632,105772,98098,7674,48860
-7.004829,8.355325,2021,E09000014,Haringey,264238,23080,46466,18556,150581,25555,216000,146328,134381,11947,69672
-7.1465626,8.614152,2021,E09000015,Harrow,261205,118152,19151,9833,95233,18836,209623,133542,125039,8503,76081
-9.504725,12.279899,2021,E09000016,Havering,262052,28150,21567,9747,197314,5274,209730,132432,124781,7651,77298
-7.8451066,10.288584,2021,E09000017,Hillingdon,305907,101938,23955,13359,147387,19268,241879,154438,142806,11632,87441
-7.4936094,9.491966,2021,E09000018,Hounslow,288181,105846,20810,13514,127083,20928,228675,150604,138794,11810,78071
-8.29045,9.729398,2021,E09000019,Islington,216590,21532,28743,16231,134754,15330,183627,124914,114971,9943,58713
-10.581892,10.136691,2021,E09000020,Kensington and Chelsea,143373,17025,11279,9525,91394,14150,123089,75072,69440,5632,48017
-11.078896,11.064382,2021,E09000021,Kingston upon Thames,168065,29938,4741,8996,114831,9559,135467,89385,84148,5237,46082
-5.506785,6.5856075,2021,E09000022,Lambeth,317650,23051,76145,25630,174778,18046,268942,197141,182817,14324,71801
-5.234674,6.17213,2021,E09000023,Lewisham,300553,26927,80473,24253,154749,14151,242417,169579,155716,13863,72838
-9.518181,10.8514185,2021,E09000024,Merton,215187,40019,22887,12765,129617,9899,172772,118900,112065,6835,53872
-5.45209,6.808568,2021,E09000025,Newham,351030,148187,61302,16419,107947,17175,276173,180739,163445,17294,95434
-6.155909,7.891229,2021,E09000026,Redbridge,310261,146833,26096,12736,107974,16622,242020,152466,141630,10836,89554
-10.460104,11.300809,2021,E09000027,Richmond upon Thames,195277,17467,3687,10662,157111,6350,155835,102821,97566,5255,53014
-6.027016,7.1359735,2021,E09000028,Southwark,307640,30540,77299,22151,158220,19430,256139,181218,166951,14267,74921
-10.371069,11.536215,2021,E09000029,Sutton,209636,36787,12465,10162,143145,7077,165659,109810,104226,5584,55849
-5.8538175,7.8787284,2021,E09000030,Tower Hamlets,310306,137856,22693,15409,122266,12082,252879,170536,155390,15146,82343
-8.228691,10.242789,2021,E09000031,Waltham Forest,278428,55545,41647,17983,147024,16229,222184,151835,140374,11461,70349
-7.0074396,10.083461,2021,E09000032,Wandsworth,327506,38314,33062,20598,222090,13442,273559,201428,190441,10987,72131
-6.956287,7.8507185,2021,E09000033,Westminster,204236,34242,16456,13335,112732,27471,177470,110288,101745,8543,67182
-13.52629,10.243108,2021,W06000001,Isle of Anglesey,68879,430,104,598,67587,160,57148,30865,29203,1662,26283
-13.065252,11.160558,2021,W06000002,Gwynedd,117392,1968,513,1333,112987,591,97968,54973,51817,3156,42995
-13.074977,11.076151,2021,W06000003,Conwy,114743,1651,271,1254,111176,391,96360,51587,48719,2868,44773
-13.368167,10.760549,2021,W06000004,Denbighshire,95820,1650,268,1052,92488,362,78908,43036,40846,2190,35872
-12.190958,11.549627,2021,W06000005,Flintshire,154960,1455,292,1446,151232,535,127578,77353,73820,3533,50225
-12.742493,11.381122,2021,W06000006,Wrexham,135122,2246,878,1558,129677,763,110274,65049,61805,3244,45225
-13.5471325,10.3503275,2021,W06000008,Ceredigion,71473,1096,366,867,68776,368,61392,31964,30119,1845,29428
-12.9100685,11.163461,2021,W06000009,Pembrokeshire,123359,1159,244,1162,120375,419,102551,55534,52765,2769,47017
-11.391752,11.848464,2021,W06000010,Carmarthenshire,187898,2321,455,1756,182652,714,155487,85874,81952,3922,69613
-10.332574,12.655801,2021,W06000011,Swansea,238491,10451,2797,3808,218052,3383,197857,107375,100613,6762,90482
-12.53951,11.38845,2021,W06000012,Neath Port Talbot,142290,2253,522,1583,137511,421,117182,62441,59191,3250,54741
-12.47005,11.455979,2021,W06000013,Bridgend,145490,2152,429,1684,140799,426,119482,67479,63984,3495,52003
-12.75667,11.290277,2021,W06000014,Vale of Glamorgan,131939,2807,624,2987,124800,721,107457,62959,59915,3044,44498
-7.603963,12.7555895,2021,W06000015,Cardiff,362310,34983,13896,14506,286931,11994,296314,172734,160440,12294,123580
-10.154079,12.301784,2021,W06000016,Rhondda Cynon Taff,237653,3506,997,2469,229923,758,193843,109606,103389,6217,84237
-11.699736,11.737641,2021,W06000018,Caerphilly,175955,1584,283,1754,171955,379,143484,81829,77439,4390,61655
-13.547384,10.219216,2021,W06000019,Blaenau Gwent,66903,621,115,569,65456,142,55141,30651,28796,1855,24490
-13.405149,10.70054,2021,W06000020,Torfaen,92276,1202,228,1005,89596,245,75112,42941,40654,2287,32171
-13.342003,10.699946,2021,W06000021,Monmouthshire,92960,1185,230,1115,90106,324,78238,44558,42829,1729,33680
-12.326256,11.795246,2021,W06000022,Newport,159592,12194,3737,4451,136473,2737,127420,77297,72787,4510,50123
-12.633938,11.257135,2021,W06000023,Powys,133169,1247,221,1135,130160,406,112536,64052,61726,2326,48484
-13.542382,10.030177,2021,W06000024,Merthyr Tydfil,58839,871,91,510,57140,227,47676,27183,25634,1549,20493
