x,y,year,geography code,geography,Ethnic Total,Asian,Black,Mixed,White,Other,Economic Total,Economically active,Economically active: In employment,Economically active: Unemployed,Economically inactive
11.687075,11.050665,2021,E06000001,Hartlepool,92338,1600,445,671,89068,554,74685,40751,37749,3002,33934
5.6056848,10.960889,2021,E06000002,Middlesbrough,143922,15090,3816,3001,118547,3468,113939,62248,56433,5815,51691
5.873546,12.567439,2021,E06000003,Redcar and Cleveland,136530,1160,265,1185,133388,532,112340,59624,55620,4004,52716
2.9313986,11.567831,2021,E06000004,Stockton-on-Tees,196593,9052,2203,2737,180937,1664,158008,92342,86442,5900,65666
10.082681,11.164948,2021,E06000005,Darlington,107796,2966,701,1472,101725,932,88103,52329,49296,3033,35774
7.8623543,12.311954,2021,E06000006,Halton,128478,1436,511,1791,123976,764,103948,62047,58706,3341,41901
2.763391,11.571017,2021,E06000007,Warrington,210973,6954,1576,3335,197305,1803,172722,107975,103195,4780,64747
5.0036535,10.303085,2021,E06000008,Blackburn with Darwen,154741,55178,1406,2596,93392,2169,119509,68111,63558,4553,51398
5.844265,12.159342,2021,E06000009,Blackpool,141039,3676,711,2210,133550,892,116338,64351,59361,4990,51987
0.97836083,11.265762,2021,E06000010,"Kingston upon Hull, City of",267013,7515,5065,4513,244989,4931,213875,128155,117788,10367,85720
-0.408626,11.304003,2021,E06000011,East Riding of Yorkshire,342215,3686,894,3197,333162,1276,288142,162798,156120,6678,125344
5.0232315,12.2500925,2021,E06000012,North East Lincolnshire,156967,2437,846,1617,151030,1037,127521,73041,68850,4191,54480
4.233852,12.41271,2021,E06000013,North Lincolnshire,169684,5622,818,1820,160052,1372,139465,80446,76221,4225,59019
2.801666,11.511944,2021,E06000014,York,202821,7634,1325,3741,188167,1954,172082,101232,96197,5035,70850
1.2430263,10.29084,2021,E06000015,Derby,261364,40901,10482,9562,192871,7548,209193,124347,116202,8145,84846
0.27713194,8.688753,2021,E06000016,Leicester,368571,159977,28766,13899,150657,15272,291012,169572,154932,14640,121440
14.59129,8.609511,2021,E06000017,Rutland,41050,634,552,744,38909,211,34297,19425,18783,642,14872
0.19592924,9.393511,2021,E06000018,Nottingham,323635,48217,32215,19063,213430,10710,264321,142935,128866,14069,121386
3.8855658,12.293947,2021,E06000019,"Herefordshire, County of",187032,2218,567,1980,181248,1019,157132,92163,88510,3653,64969
3.2760108,10.921362,2021,E06000020,Telford and Wrekin,185543,10067,5351,4844,163638,1643,148670,90380,85495,4885,58290
1.3694711,10.800326,2021,E06000021,Stoke-on-Trent,258369,25597,6884,5860,215699,4329,205899,119972,112580,7392,85927
3.0740352,11.196379,2021,E06000022,Bath and North East Somerset,193409,6389,1846,5256,178308,1610,161616,94452,89810,4642,67164
-1.0265641,10.224096,2021,E06000023,"Bristol, City of",472467,31269,27890,21116,383142,9050,389708,252652,238510,14142,137056
2.7044172,11.588518,2021,E06000024,North Somerset,216729,3322,1139,3635,207429,1204,178567,106639,102702,3937,71928
0.50534236,11.058203,2021,E06000025,South Gloucestershire,290424,11094,4534,7289,264856,2651,237366,153466,147612,5854,83900
0.9177177,11.40102,2021,E06000026,Plymouth,264695,5947,2786,4656,248727,2579,218624,128144,121018,7126,90480
5.910216,12.598002,2021,E06000027,Torbay,139324,2254,447,2084,133922,617,117030,62379,58935,3444,54651
2.049384,10.540385,2021,E06000030,Swindon,233411,27173,6123,6495,190142,3478,187151,123902,117866,6036,63249
2.2409973,10.21863,2021,E06000031,Peterborough,215670,30801,8751,7617,162581,5920,167574,107102,100969,6133,60472
1.3621744,9.430022,2021,E06000032,Luton,225261,83325,22735,9620,101798,7783,172695,107846,98718,9128,64849
3.3372045,10.953856,2021,E06000033,Southend-on-Sea,180685,9864,5153,5553,158079,2036,146410,88636,83259,5377,57774
3.3481903,10.606312,2021,E06000034,Thurrock,175993,12205,20877,5252,134984,2675,136364,91113,85948,5165,45251
0.94846356,10.562497,2021,E06000035,Medway,279773,16484,15723,7859,235747,3960,222755,140571,132604,7967,82184
6.901125,10.670139,2021,E06000036,Bracknell Forest,124605,8879,2993,3843,107269,1621,99934,69400,66397,3003,30534
4.9127283,11.323506,2021,E06000037,West Berkshire,161447,5990,2030,3857,148384,1186,130737,85510,82308,3202,45227
2.8266556,9.957659,2021,E06000038,Reading,174223,30841,12532,8962,116886,5002,141357,94693,88864,5829,46664
3.038878,9.750657,2021,E06000039,Slough,158500,74093,11992,6311,57134,8970,118933,79719,73699,6020,39214
5.1383057,10.432841,2021,E06000040,Windsor and Maidenhead,153497,20072,2358,5238,122551,3278,123676,80096,76302,3794,43580
3.5471203,10.561481,2021,E06000041,Wokingham,177502,22868,4306,5574,141851,2903,140821,93243,89467,3776,47578
0.8790908,9.941858,2021,E06000042,Milton Keynes,287060,35645,27851,11725,206114,5725,224835,151684,143379,8305,73151
0.7336401,10.481838,2021,E06000043,Brighton and Hove,277103,13217,5458,13228,236571,8629,235365,150125,139289,10836,85240
2.4785914,10.798283,2021,E06000044,Portsmouth,208001,14370,7070,5487,177277,3797,170818,105376,97785,7591,65442
1.398247,10.459223,2021,E06000045,Southampton,248920,26414,7539,8309,200829,5829,204369,126584,118228,8356,77785
5.8256173,12.67676,2021,E06000046,Isle of Wight,140459,1663,478,1720,136219,379,119584,61399,57909,3490,58185
-0.9021137,10.690153,2021,E06000047,County Durham,522067,7834,1740,4949,505471,2073,433958,235484,222215,13269,198474
-0.73171127,10.969288,2021,E06000049,Cheshire East,398772,9531,2422,7059,376543,3217,329474,200289,192487,7802,129185
-0.50810945,11.155541,2021,E06000050,Cheshire West and Chester,357149,7231,2107,5291,340361,2159,295358,177228,169088,8140,118130
-0.2683866,11.382278,2021,E06000051,Shropshire,323607,4324,1117,3861,312876,1429,272245,158910,152422,6488,113335
-0.98702097,10.545376,2021,E06000052,Cornwall,570305,4032,1058,7030,552130,6055,477425,266622,254247,12375,210803
14.545182,8.529317,2021,E06000053,Isles of Scilly,2055,6,4,23,2004,18,1729,1128,1113,15,601
-0.9465919,10.722154,2021,E06000054,Wiltshire,510333,10876,5786,8709,481413,3549,419114,262075,252345,9730,157039
2.8316627,10.139588,2021,E06000055,Bedford,185224,23263,9848,8586,140174,3353,148118,95811,90865,4946,52307
0.5272274,10.904544,2021,E06000056,Central Bedfordshire,294251,10321,7018,8885,265545,2482,236760,157292,151077,6215,79468
-0.25288463,11.393692,2021,E06000057,Northumberland,320566,3374,598,2557,313027,1010,268850,148602,140780,7822,120248
-0.73531103,10.772041,2021,E06000058,"Bournemouth, Christchurch and Poole",400195,13551,4233,11093,365510,5808,334908,197215,186030,11185,137693
-0.6274605,11.248603,2021,E06000059,Dorset,379580,4305,1082,4436,368415,1342,321900,174681,167777,6904,147219
-0.9570413,10.333305,2021,E06000060,Buckinghamshire,553078,68318,14269,19570,442164,8757,443394,285487,273235,12252,157907
-0.43975562,10.99169,2021,E06000061,North Northamptonshire,359523,12726,11017,8175,324664,2941,289187,186661,178857,7804,102526
-0.7650826,10.58227,2021,E06000062,West Northamptonshire,425723,22463,20661,12116,365758,4725,343503,226381,215996,10385,117122
5.0177884,10.348681,2021,E07000008,Cambridge,145674,21626,3561,7410,108570,4507,124765,74213,70598,3615,50552
11.5789,10.059696,2021,E07000009,East Cambridgeshire,87763,1688,705,1883,82912,575,71429,46215,44695,1520,25214
10.6250725,11.37528,2021,E07000010,Fenland,102461,1232,814,1412,98280,723,84835,49392,47109,2283,35443
3.6360028,11.025606,2021,E07000011,Huntingdonshire,180832,5745,2646,4057,167116,1268,148261,94850,91391,3459,53411
4.9789357,11.068033,2021,E07000012,South Cambridgeshire,162117,9399,2019,4591,144285,1823,130361,85049,82267,2782,45312
11.614257,11.164864,2021,E07000026,Allerdale,96153,540,84,627,94667,235,80510,46015,44235,1780,34495
13.88776,8.891433,2021,E07000027,Barrow-in-Furness,67406,949,250,550,65412,245,55834,32692,31183,1509,23142
9.746128,11.712334,2021,E07000028,Carlisle,110025,1628,337,973,106508,579,91343,55272,52950,2322,36071
13.888114,8.98497,2021,E07000029,Copeland,67076,547,185,450,65714,180,56009,31946,30571,1375,24063
14.585057,8.63283,2021,E07000030,Eden,54737,435,87,368,53699,148,46635,28183,27335,848,18452
10.745816,11.603692,2021,E07000031,South Lakeland,104450,812,251,1034,102025,328,89703,51636,50137,1499,38067
7.7915897,12.279419,2021,E07000032,Amber Valley,126204,1208,381,1548,122767,300,105066,62625,60171,2454,42441
12.262194,9.975055,2021,E07000033,Bolsover,80270,722,419,744,78143,242,66278,39653,38100,1553,26625
10.4221945,11.407274,2021,E07000034,Chesterfield,103568,1950,839,1498,98857,424,86004,49883,47532,2351,36121
13.749818,9.039908,2021,E07000035,Derbyshire Dales,71535,518,169,723,69940,185,61061,34373,33229,1144,26688
9.326487,11.635592,2021,E07000036,Erewash,112908,1788,871,2048,107769,432,93526,57478,54966,2512,36048
11.711539,10.64398,2021,E07000037,High Peak,90935,694,223,1185,88614,219,75662,46481,44616,1865,29181
10.940273,11.473695,2021,E07000038,North East Derbyshire,102003,952,324,1170,99367,190,85275,48471,46564,1907,36804
10.041728,11.414476,2021,E07000039,South Derbyshire,107206,3841,855,1934,99836,740,86956,55907,53907,2000,31049
5.275428,12.622114,2021,E07000040,East Devon,150823,1459,348,1720,146847,449,127388,69189,66727,2462,58199
6.972662,11.730092,2021,E07000041,Exeter,130707,6375,1137,3308,118034,1853,111331,63256,59701,3555,48075
12.208173,10.098918,2021,E07000042,Mid Devon,82853,562,101,899,81068,223,68203,41654,40279,1375,26549
11.213265,11.309535,2021,E07000043,North Devon,98612,1135,325,1174,95639,339,82194,47138,45166,1972,35056
12.2186985,10.679214,2021,E07000044,South Hams,88628,614,149,1048,86427,390,74968,42013,40585,1428,32955
6.9733505,12.435795,2021,E07000045,Teignbridge,134802,1004,216,1564,131668,350,113461,64536,62137,2399,48925
13.874548,9.063705,2021,E07000046,Torridge,68114,356,75,630,66920,133,57560,31418,30054,1364,26142
14.472124,8.615121,2021,E07000047,West Devon,57094,337,122,626,55847,162,48362,26317,25384,933,22045
10.254099,10.870258,2021,E07000061,Eastbourne,101680,3544,1308,2802,92342,1684,84573,46757,43831,2926,37816
11.017528,9.887502,2021,E07000062,Hastings,90995,2536,1262,2639,83191,1367,74702,43772,40897,2875,30930
10.699405,10.907583,2021,E07000063,Lewes,99909,1899,722,2461,94101,726,83221,46800,44506,2294,36421
11.596053,11.21951,2021,E07000064,Rother,93114,1390,561,1702,88993,468,79489,39914,37934,1980,39575
4.691512,12.433533,2021,E07000065,Wealden,160152,2250,646,2709,153809,738,133648,77504,74543,2961,56144
3.22563,10.790596,2021,E07000066,Basildon,187567,7995,8913,4938,164116,1605,148662,93971,89010,4961,54691
5.033669,11.747492,2021,E07000067,Braintree,155265,2566,1889,3014,146981,815,126567,79834,76282,3552,46733
11.635917,9.671902,2021,E07000068,Brentwood,77048,3913,1747,2368,68194,826,62866,39506,37900,1606,23360
11.897434,10.511882,2021,E07000069,Castle Point,89582,1550,1179,1446,84981,426,74405,42904,41002,1902,31501
3.5579672,10.918188,2021,E07000070,Chelmsford,181523,9646,4756,4724,160701,1696,147737,93844,89861,3983,53893
3.1168694,10.811029,2021,E07000071,Colchester,192716,9907,6661,5602,167701,2845,156342,97495,92015,5480,58847
5.5823293,10.335847,2021,E07000072,Epping Forest,134980,9678,3932,4896,113469,3005,109932,69230,65796,3434,40702
10.791626,9.516007,2021,E07000073,Harlow,93330,5555,5827,3048,77214,1686,73102,48826,45981,2845,24276
13.943957,8.808507,2021,E07000074,Maldon,66211,741,236,897,64129,208,55426,32581,31254,1327,22845
12.013182,10.128566,2021,E07000075,Rochford,85662,1185,633,1432,82116,296,70713,42485,40661,1824,28228
5.764564,12.578222,2021,E07000076,Tendring,148293,1794,910,2393,142656,540,124890,62132,58280,3852,62758
11.443581,10.139226,2021,E07000077,Uttlesford,91344,1722,709,2016,86296,601,73519,47470,45740,1730,26049
8.465625,10.951365,2021,E07000078,Cheltenham,118836,4922,1181,2949,108559,1225,98436,61873,59157,2716,36563
11.796718,10.619208,2021,E07000079,Cotswold,90830,1195,402,1393,87510,330,76315,45652,44079,1573,30663
12.109068,10.577718,2021,E07000080,Forest of Dean,87004,625,242,925,84869,343,73046,41777,39989,1788,31269
5.9815335,10.428295,2021,E07000081,Gloucester,132414,8543,4826,5014,112461,1570,106939,68956,65621,3335,37983
8.577277,11.851297,2021,E07000082,Stroud,121104,1256,528,2171,116701,448,100197,62038,59919,2119,38159
11.418523,10.509656,2021,E07000083,Tewkesbury,94882,1924,595,1699,90206,458,77353,48226,46524,1702,29127
3.5692627,10.931552,2021,E07000084,Basingstoke and Deane,185154,10967,3611,4717,163840,2019,149807,101108,96973,4135,48699
7.814114,11.944224,2021,E07000085,East Hampshire,125742,2370,658,2079,119993,642,103829,64115,61732,2383,39714
7.0679374,11.565329,2021,E07000086,Eastleigh,136444,5256,1300,2817,126083,988,110330,72212,69514,2698,38118
9.234157,11.700031,2021,E07000087,Fareham,114512,2114,670,1727,109499,502,95636,57693,55629,2064,37943
12.145095,9.912191,2021,E07000088,Gosport,81949,1169,984,1210,78136,450,67213,40568,38486,2082,26645
10.787287,10.460692,2021,E07000089,Hart,99404,3595,843,2231,91952,783,80326,52411,50444,1967,27915
8.225799,12.339075,2021,E07000090,Havant,124210,2107,750,1719,119127,507,102866,59350,56369,2981,43516
4.175997,12.403638,2021,E07000091,New Forest,175782,2103,703,2215,170118,643,148742,81777,78700,3077,66965
10.519053,9.323058,2021,E07000092,Rushmoor,99759,14658,2531,2578,77219,2773,80872,55548,53017,2531,25324
7.2653437,11.660707,2021,E07000093,Test Valley,130491,4284,1458,2312,121457,980,106753,68171,65862,2309,38582
7.617372,11.801086,2021,E07000094,Winchester,127444,3917,792,2590,119305,840,104750,63289,60573,2716,41461
10.476729,9.419644,2021,E07000095,Broxbourne,99007,3657,6588,3930,80301,4531,79437,50969,48306,2663,28468
5.199938,10.78037,2021,E07000096,Dacorum,155081,8948,4411,5266,134602,1854,123783,80791,77199,3592,42992
10.263672,9.2150345,2021,E07000098,Hertsmere,107827,11320,5181,4038,83145,4143,86193,55526,52767,2759,30667
6.0212717,10.471035,2021,E07000099,North Hertfordshire,133210,6956,3235,4913,116620,1486,107743,70011,67162,2849,37732
10.814327,9.428223,2021,E07000102,Three Rivers,93772,14265,2233,3390,72316,1568,75002,49093,46947,2146,25909
10.301675,9.215995,2021,E07000103,Watford,102245,25037,6488,4844,62228,3648,80963,55941,52859,3082,25022
7.1615505,11.33704,2021,E07000105,Ashford,132747,7668,3424,2877,116896,1882,106770,66680,63616,3064,40090
5.4960833,11.191446,2021,E07000106,Canterbury,157429,6377,3906,4316,140473,2357,132778,71404,66169,5235,61374
10.114106,9.178861,2021,E07000107,Dartford,116754,11513,12282,3638,86936,2385,90698,61827,58823,3004,28871
8.884387,12.282171,2021,E07000108,Dover,116411,2402,837,1754,110419,999,96135,53982,50929,3053,42153
10.295741,9.230965,2021,E07000109,Gravesham,106902,11999,6952,2828,81893,3230,84556,53012,49761,3251,31544
3.6578288,10.967554,2021,E07000110,Maidstone,175781,8213,3606,4013,157864,2085,142136,90263,86409,3854,51873
8.540994,10.9828415,2021,E07000111,Sevenoaks,120515,3484,1932,3181,111005,913,96603,58728,56384,2344,37875
9.774115,11.222009,2021,E07000112,Folkestone and Hythe,109759,4271,682,2108,101614,1084,91555,50765,47819,2946,40790
5.243668,11.988998,2021,E07000113,Swale,151677,2312,3487,2741,142341,796,121998,73117,69201,3916,48881
5.963922,12.051002,2021,E07000114,Thanet,140587,3259,1481,3420,130719,1708,115413,63337,59189,4148,52076
7.38976,11.690798,2021,E07000115,Tonbridge and Malling,132201,3876,1314,2943,123287,781,105526,66991,64426,2565,38535
8.723421,10.945864,2021,E07000116,Tunbridge Wells,115314,4566,1131,2949,105562,1106,92402,58284,55898,2386,34118
11.401475,9.541175,2021,E07000117,Burnley,94651,13930,326,1505,78112,778,75200,42735,40035,2700,32465
9.110098,11.756455,2021,E07000118,Chorley,117733,2204,653,1773,112588,515,96370,59510,57244,2266,36860
12.316995,10.065589,2021,E07000119,Fylde,81375,1173,331,1158,78332,381,69251,37339,35718,1621,31912
11.82712,9.541788,2021,E07000120,Hyndburn,82237,12401,224,1091,67984,537,65631,37843,35627,2216,27788
6.032755,12.513287,2021,E07000121,Lancaster,142939,5155,1215,2204,133063,1302,119638,65780,62399,3381,53858
11.232657,9.495029,2021,E07000122,Pendle,95758,25573,244,1488,67577,876,75224,42012,39625,2387,33212
5.071615,10.397686,2021,E07000123,Preston,147834,29815,3489,4367,107321,2842,118670,71191,66634,4557,47479
14.322563,8.677292,2021,E07000124,Ribble Valley,61565,1265,125,736,59256,183,51465,31251,30385,866,20214
13.697599,8.796752,2021,E07000125,Rossendale,70868,3876,172,1043,65510,267,57301,34680,33118,1562,22621
9.464054,11.575047,2021,E07000126,South Ribble,111035,2307,539,1908,105919,362,91498,56754,54709,2045,34744
8.650298,12.375471,2021,E07000127,West Lancashire,117429,1232,388,1547,113795,467,98334,56523,53547,2976,41811
9.406151,12.274637,2021,E07000128,Wyre,111946,1109,273,1135,109139,290,94352,50307,47835,2472,44045
10.491469,10.163154,2021,E07000129,Blaby,102924,8497,1594,2765,88753,1315,83666,53511,51446,2065,30155
3.2969801,10.812421,2021,E07000130,Charnwood,183970,22853,2840,4660,151459,2158,153100,89169,84799,4370,63931
10.945973,10.446549,2021,E07000131,Harborough,97623,5298,699,2003,88851,772,80427,50315,48770,1545,30112
9.276123,11.593431,2021,E07000132,Hinckley and Bosworth,113641,3147,692,1990,107180,632,93916,57944,55885,2059,35972
14.634596,8.573268,2021,E07000133,Melton,51752,599,192,659,50142,160,42948,26369,25468,901,16579
10.37954,11.476211,2021,E07000134,North West Leicestershire,104707,1543,642,1592,100449,481,86165,54001,51961,2040,32164
14.250916,8.66435,2021,E07000135,Oadby and Wigston,57747,16131,1254,1873,36592,1897,47210,27441,25989,1452,19769
13.767152,8.838378,2021,E07000136,Boston,70505,1443,467,1015,66733,847,57584,35260,33631,1629,22324
5.813766,12.578546,2021,E07000137,East Lindsey,142295,1134,292,1484,139100,285,121420,59088,55579,3509,62332
10.161438,10.978515,2021,E07000138,Lincoln,103814,3347,1466,2068,95665,1268,87064,50590,46715,3875,36474
8.956283,11.886407,2021,E07000139,North Kesteven,118072,1160,416,1368,114729,399,98017,58978,56894,2084,39039
11.506048,10.849781,2021,E07000140,South Holland,95122,1176,517,1225,91623,581,78998,47209,45234,1975,31789
6.4811993,12.362135,2021,E07000141,South Kesteven,143405,2529,875,1951,137421,629,118011,71185,68195,2990,46826
11.730536,11.193563,2021,E07000142,West Lindsey,95153,1136,333,1081,92261,342,79120,44159,42138,2021,34961
6.4925656,12.459561,2021,E07000143,Breckland,141477,1340,820,2051,136457,809,117855,68440,65638,2802,49415
7.101859,12.354077,2021,E07000144,Broadland,131723,1831,684,1842,126869,497,110505,64827,62589,2238,45678
10.530562,11.04658,2021,E07000145,Great Yarmouth,99750,1936,1104,1575,94361,774,82719,44475,41139,3336,38244
4.9766974,12.50253,2021,E07000146,King's Lynn and West Norfolk,154326,2886,843,2022,147563,1012,128888,72399,69220,3179,56489
10.364022,11.92012,2021,E07000147,North Norfolk,102978,565,183,978,101007,245,89143,43616,41657,1959,45527
5.576883,10.93718,2021,E07000148,Norwich,143924,7867,3578,4519,125421,2539,120763,71055,65720,5335,49708
6.694753,12.336425,2021,E07000149,South Norfolk,141948,2562,1164,2094,135474,654,117219,70090,67749,2341,47129
14.546085,8.562827,2021,E07000163,Craven,56927,972,87,569,55143,156,48283,27943,27131,812,20340
12.045206,10.806152,2021,E07000164,Hambleton,90692,664,244,741,88764,279,76985,44737,43405,1332,32248
4.6266065,12.376341,2021,E07000165,Harrogate,162668,2947,1036,2573,155244,868,135306,82286,79686,2600,53020
14.515594,8.665265,2021,E07000166,Richmondshire,49781,1346,440,462,46989,544,41736,25526,24675,851,16210
14.670195,8.524998,2021,E07000167,Ryedale,54707,325,93,424,53701,164,46325,26772,25961,811,19553
9.967773,12.001903,2021,E07000168,Scarborough,108736,1372,331,1069,105460,504,92109,48974,46549,2425,43135
11.7701845,10.633665,2021,E07000169,Selby,91988,694,228,884,89854,328,75430,47832,46121,1711,27598
7.9422975,12.169626,2021,E07000170,Ashfield,126299,1968,1575,2059,120147,550,102843,61531,58427,3104,41312
8.92251,11.970314,2021,E07000171,Bassetlaw,117803,1455,736,1405,113620,587,97370,57282,54920,2362,40088
9.054502,10.88136,2021,E07000172,Broxtowe,110940,6152,1867,2819,98636,1466,92538,54415,51915,2500,38123
8.641666,10.88976,2021,E07000173,Gedling,117264,4532,2675,4130,104918,1009,96462,58689,56186,2503,37773
9.865556,11.456798,2021,E07000174,Mansfield,110482,2234,1174,1544,104712,818,90170,53882,51367,2515,36288
8.206115,12.190421,2021,E07000175,Newark and Sherwood,122959,1411,804,1844,118366,534,101968,59562,57114,2448,42406
8.615259,10.874705,2021,E07000176,Rushcliffe,119077,6775,1095,3303,106827,1077,97724,59116,56978,2138,38608
4.807572,10.958931,2021,E07000177,Cherwell,161015,9706,2845,4614,141831,2019,130586,88197,84970,3227,42389
3.0051196,9.940627,2021,E07000178,Oxford,162040,24991,7535,9005,114561,5948,136718,77669,73326,4343,59049
5.156992,11.4212,2021,E07000179,South Oxfordshire,149088,4263,1467,3402,138785,1171,121491,79136,76476,2660,42355
6.6382523,11.418574,2021,E07000180,Vale of White Horse,138913,5490,2315,3452,126104,1552,112425,73280,70863,2417,39145
9.227732,11.5956545,2021,E07000181,West Oxfordshire,114236,1936,722,2141,108773,664,93810,60809,58926,1883,33001
9.121799,11.760971,2021,E07000187,Mendip,116089,1298,369,1666,112351,405,96052,57860,55671,2189,38192
7.916016,12.27857,2021,E07000188,Sedgemoor,125341,1806,423,1431,121085,596,103782,61679,59148,2531,42103
4.285047,12.27828,2021,E07000189,South Somerset,172670,2330,816,2023,166829,672,143817,84072,80935,3137,59745
10.637267,11.318951,2021,E07000192,Cannock Chase,100523,1208,472,1422,97131,290,82478,51378,48877,2501,31100
8.271356,10.943022,2021,E07000193,East Staffordshire,124021,11552,1376,2723,107051,1319,100507,62173,59316,2857,38334
10.082503,11.438696,2021,E07000194,Lichfield,106436,2496,601,1987,100917,435,88597,52639,50473,2166,35958
8.102591,12.266197,2021,E07000195,Newcastle-under-Lyme,123299,4642,1289,1988,114523,857,103184,59643,56683,2960,43541
9.536869,11.407262,2021,E07000196,South Staffordshire,110475,3108,1031,2242,103570,524,93372,52966,50699,2267,40406
6.8933787,12.091853,2021,E07000197,Stafford,136870,4165,1440,2552,127805,908,113614,68385,65765,2620,45229
11.631714,11.156695,2021,E07000198,Staffordshire Moorlands,95844,658,188,902,93931,165,80856,46650,45037,1613,34206
12.03967,9.805774,2021,E07000199,Tamworth,78642,1081,492,1472,75309,288,63793,40229,38161,2068,23564
11.743372,10.829453,2021,E07000200,Babergh,92342,875,503,1351,89269,344,77378,44824,42956,1868,32554
5.598048,10.381027,2021,E07000202,Ipswich,139643,7611,4882,6409,117757,2984,111832,71116,67026,4090,40716
10.676524,11.604068,2021,E07000203,Mid Suffolk,102701,821,553,1463,99463,401,86305,51759,50024,1735,34546
5.709833,10.424409,2021,E07000207,Elmbridge,138755,9052,1730,5688,119500,2785,108774,70000,66980,3020,38774
11.120488,9.594162,2021,E07000208,Epsom and Ewell,80937,9233,1569,3550,64312,2273,64607,41717,39910,1807,22890
5.482944,10.729318,2021,E07000209,Guildford,143647,9630,2150,4386,124788,2693,119356,73429,69774,3655,45927
11.468246,9.90551,2021,E07000210,Mole Valley,87387,2637,706,2194,81046,804,72339,44028,42342,1686,28311
5.3540907,10.581823,2021,E07000211,Reigate and Banstead,150846,11383,4415,5541,127334,2173,120127,78471,75124,3347,41656
11.00458,9.612636,2021,E07000212,Runnymede,88079,8140,1591,3113,73557,1678,72719,45103,42456,2647,27616
10.40382,9.315134,2021,E07000213,Spelthorne,102960,13146,2548,3763,81000,2503,83363,54555,51540,3015,28808
11.062251,9.648424,2021,E07000214,Surrey Heath,90456,8057,1428,2460,76901,1610,73785,47447,45364,2083,26338
11.210436,9.787921,2021,E07000215,Tandridge,87877,3271,1929,3331,78584,762,70827,44452,42576,1876,26375
7.723147,11.671371,2021,E07000216,Waverley,128226,3625,887,2846,120088,780,103639,63121,60725,2396,40518
10.53154,9.390654,2021,E07000217,Woking,103943,14741,1879,3614,81529,2180,82984,55238,52744,2494,27746
13.892769,8.779941,2021,E07000218,North Warwickshire,65036,844,364,1113,62514,201,53898,33210,31754,1456,20688
7.257497,11.538105,2021,E07000219,Nuneaton and Bedworth,134198,10782,2446,2449,116939,1582,108590,66590,63115,3475,42000
8.861728,10.736547,2021,E07000220,Rugby,114363,8728,3110,3202,98013,1310,92188,60387,58107,2280,31801
6.9333816,12.205001,2021,E07000221,Stratford-on-Avon,134724,2566,482,2288,128672,716,112639,68512,66236,2276,44127
5.323906,10.658589,2021,E07000222,Warwick,148454,14403,1616,4479,125534,2422,123254,76199,72748,3451,47055
14.097217,8.672639,2021,E07000223,Adur,64543,1395,530,1627,60294,697,52954,31271,29825,1446,21683
4.3624167,12.433198,2021,E07000224,Arun,164887,2630,857,2484,158002,914,139553,76832,73190,3642,62721
8.177854,12.266701,2021,E07000225,Chichester,124071,2168,783,2047,118404,669,104709,59081,56365,2716,45628
10.038019,9.160226,2021,E07000226,Crawley,118492,18236,5331,4838,86939,3148,93567,63548,58899,4649,30019
5.269675,11.646279,2021,E07000227,Horsham,146776,3974,1312,3130,137442,918,120663,75077,72167,2910,45586
5.050747,11.313746,2021,E07000228,Mid Sussex,152566,5505,1337,3827,140724,1173,123317,79510,76573,2937,43807
9.013438,10.881553,2021,E07000229,Worthing,111338,4387,1281,2854,101709,1107,92355,56302,53557,2745,36053
10.795724,10.680405,2021,E07000234,Bromsgrove,99183,3159,766,2414,92309,535,81102,49278,47288,1990,31824
12.330826,9.929032,2021,E07000235,Malvern Hills,79487,1051,262,1119,76779,276,67122,37354,35802,1552,29768
11.443751,9.856676,2021,E07000236,Redditch,87034,4995,1054,2283,78173,529,70250,44849,42692,2157,25401
9.988657,10.743421,2021,E07000237,Worcester,103869,5860,1212,2283,93478,1036,85605,54601,51627,2974,31004
7.072166,12.356786,2021,E07000238,Wychavon,132495,1510,461,1600,128325,599,110717,66063,63660,2403,44654
10.702308,11.256884,2021,E07000239,Wyre Forest,101609,1939,395,1470,97423,382,84565,48237,45789,2448,36328
5.3928075,10.442836,2021,E07000240,St Albans,148169,12176,3159,6354,123865,2615,116090,75854,72870,2984,40236
9.930788,9.180624,2021,E07000241,Welwyn Hatfield,119835,10595,7307,4931,94298,2704,97484,61950,58149,3801,35534
5.134343,11.29322,2021,E07000242,East Hertfordshire,150159,4019,1951,4245,138587,1357,121151,79595,76526,3069,41556
10.940379,9.560955,2021,E07000243,Stevenage,89498,6700,4340,3216,74099,1143,71239,47817,45463,2354,23422
1.2799107,11.627746,2021,E07000244,East Suffolk,246060,3447,1357,3707,236627,922,206721,111807,106367,5440,94914
3.573412,10.96969,2021,E07000245,West Suffolk,179948,4731,2873,4880,165156,2308,148130,93203,89622,3581,54927
4.850406,12.513413,2021,E07000246,Somerset West and Taunton,157447,3224,827,2019,150583,794,131294,76213,73293,2920,55081
1.2379265,10.364342,2021,E08000001,Bolton,295960,59596,11238,6643,212941,5542,232293,134542,125439,9103,97751
2.9740534,10.756329,2021,E08000002,Bury,193851,20593,3690,5123,160716,3729,154871,93461,88481,4980,61410
-0.77136296,9.714375,2021,E08000003,Manchester,551938,115109,65893,29026,313632,28278,437958,259288,234284,25004,178670
1.8592212,10.408357,2021,E08000004,Oldham,242087,59565,8209,6125,164897,3291,187035,105966,98206,7760,81069
2.0761535,10.503219,2021,E08000005,Rochdale,223771,41406,7927,5284,165485,3669,174947,101069,94459,6610,73878
0.9388769,10.344381,2021,E08000006,Salford,269922,14938,16473,8501,222248,7762,216921,137780,127605,10175,79141
0.580984,11.013423,2021,E08000007,Stockport,294770,21464,3416,7668,257530,4692,238927,146544,139806,6738,92383
2.1506832,10.811889,2021,E08000008,Tameside,231070,21198,5275,4963,197676,1958,185136,112079,105655,6424,73057
1.9502398,10.334079,2021,E08000009,Trafford,235053,29588,8086,8834,182761,5784,186150,117117,111557,5560,69033
-0.2519443,11.242185,2021,E08000010,Wigan,329330,5826,3907,4353,312952,2292,268694,162896,154614,8282,105798
5.1572447,12.145691,2021,E08000011,Knowsley,154518,2510,1264,2658,147234,852,124297,73881,69490,4391,50416
-0.87441164,10.353955,2021,E08000012,Liverpool,486088,27767,16964,16880,408443,16034,403028,224956,205750,19206,178072
3.9244273,12.317538,2021,E08000013,St. Helens,183248,2579,776,1971,176888,1034,150572,87330,82624,4706,63242
0.7524605,11.393175,2021,E08000014,Sefton,279233,4294,1509,4056,267540,1834,232389,131658,124596,7062,100731
-0.14552738,11.368479,2021,E08000015,Wirral,320199,7302,1389,4930,304692,1886,262111,147023,139503,7520,115088
1.2907047,11.567672,2021,E08000016,Barnsley,244572,2297,1715,2293,236934,1333,199792,117520,111680,5840,82272
0.2080386,11.264407,2021,E08000017,Doncaster,308104,9086,3742,4603,286955,3718,250926,146264,137859,8405,104662
1.0649523,11.4476385,2021,E08000018,Rotherham,265806,14176,3016,3854,241954,2806,215571,124654,117801,6853,90917
-0.9597877,10.160729,2021,E08000019,Sheffield,556523,53560,25512,19704,440216,17531,456247,260057,242006,18051,196190
0.8245501,10.437786,2021,E08000021,Newcastle upon Tyne,300127,34128,9921,6920,240002,9156,248447,136892,125075,11817,111555
2.6902554,11.634587,2021,E08000022,North Tyneside,208968,5396,1281,2879,198208,1204,171513,102868,97266,5602,68645
5.6172686,12.182529,2021,E08000023,South Tyneside,147777,4317,786,1995,139483,1196,121291,67794,62508,5286,53497
0.7700046,11.442637,2021,E08000024,Sunderland,274173,8204,2665,2505,259375,1424,226074,125948,117154,8794,100126
-0.85893774,9.866933,2021,E08000025,Birmingham,1144922,355384,125760,55205,556608,51965,889622,494724,442417,52307,394898
0.26539496,9.466268,2021,E08000026,Coventry,345321,63915,30723,11731,226246,12706,276871,163686,150141,13545,113185
0.3492241,10.726169,2021,E08000027,Dudley,323488,27047,8170,9191,274596,4484,262488,154502,144640,9862,107986
0.27796194,8.988277,2021,E08000028,Sandwell,341832,88024,29779,14680,195624,13725,266026,155194,141070,14124,110832
2.243545,10.563353,2021,E08000029,Solihull,216240,23845,3955,7496,177668,3276,174501,103460,97939,5521,71041
1.1012268,10.256563,2021,E08000030,Walsall,284126,53199,13024,9317,202724,5862,223097,128492,118530,9962,94605
0.9285166,9.38399,2021,E08000031,Wolverhampton,263726,55901,24636,14065,159707,9417,208444,122990,111311,11679,85454
-0.6914146,10.09004,2021,E08000032,Bradford,546412,175664,10978,15006,334004,10760,421574,239279,221136,18143,182295
2.7615023,11.191772,2021,E08000033,Calderdale,206631,21726,1439,4027,177836,1603,166634,98755,93382,5373,67879
-0.5524473,10.32789,2021,E08000034,Kirklees,433213,84202,9948,13588,318969,6506,346271,202190,190084,12106,144081
-0.9381158,10.076061,2021,E08000035,Leeds,811953,78503,45376,27388,641801,18885,658470,401119,374063,27056,257351
-0.43035477,11.150578,2021,E08000036,Wakefield,353370,12633,4516,4938,328742,2541,287538,173152,164641,8511,114386
3.119185,11.749576,2021,E08000037,Gateshead,196149,4925,2214,2393,183489,3128,161749,93515,87519,5996,68234
14.6396,8.481744,2021,E09000001,City of London,8584,1445,232,470,5955,482,8004,5678,5351,327,2326
1.2708272,9.452686,2021,E09000002,Barking and Dagenham,218871,56583,46807,9320,98275,7886,161746,103667,94591,9076,58079
-0.19185854,8.899052,2021,E09000003,Barnet,389344,74972,30651,20889,224762,38070,309355,199761,186176,13585,109594
1.1766223,9.954498,2021,E09000004,Bexley,246475,24434,30075,8740,177164,6062,195827,125346,117983,7363,70481
-0.24979378,8.840878,2021,E09000005,Brent,339821,111515,59495,17249,117701,33861,275142,175982,160998,14984,99160
0.23315293,9.830766,2021,E09000006,Bromley,329991,27307,25149,17740,252295,7500,265088,171090,162122,8968,93998
1.1037416,9.221926,2021,E09000007,Camden,210136,38042,18892,13938,125064,14200,177908,111524,102511,9013,66384
-0.47645828,9.321063,2021,E09000008,Croydon,390724,68487,88441,29745,188985,15066,310396,204136,189405,14731,106260
-0.31847826,8.805139,2021,E09000009,Ealing,367116,111241,39491,19161,158463,38760,295371,190291,175026,15265,105080
-0.36403826,8.886976,2021,E09000010,Enfield,329985,37973,60512,19558,171884,40058,257182,156015,143864,12151,101167
-0.15367272,9.204448,2021,E09000011,Greenwich,289065,38028,60602,17297,161006,12132,229749,155202,142935,12267,74547
-0.25533852,9.011187,2021,E09000012,Hackney,259147,26885,54645,17487,137709,22421,209466,145767,134308,11459,63699
1.321575,9.29833,2021,E09000013,Hammersmith and Fulham,183156,19306,22453,12318,115679,13400,154632,105772,98098,7674,48860
-0.1096738,9.101938,2021,E09000014,Haringey,264238,23080,46466,18556,150581,25555,216000,146328,134381,11947,69672
0.5569001,8.753572,2021,E09000015,Harrow,261205,118152,19151,9833,95233,18836,209623,133542,125039,8503,76081
1.0869704,10.104438,2021,E09000016,Havering,262052,28150,21567,9747,197314,5274,209730,132432,124781,7651,77298
0.36232138,8.824226,2021,E09000017,Hillingdon,305907,101938,23955,13359,147387,19268,241879,154438,142806,11632,87441
0.43685323,8.812832,2021,E09000018,Hounslow,288181,105846,20810,13514,127083,20928,228675,150604,138794,11810,78071
0.90046126,9.245891,2021,E09000019,Islington,216590,21532,28743,16231,134754,15330,183627,124914,114971,9943,58713
2.6642585,9.718884,2021,E09000020,Kensington and Chelsea,143373,17025,11279,9525,91394,14150,123089,75072,69440,5632,48017
2.829954,9.877063,2021,E09000021,Kingston upon Thames,168065,29938,4741,8996,114831,9559,135467,89385,84148,5237,46082
-0.3593913,9.198272,2021,E09000022,Lambeth,317650,23051,76145,25630,174778,18046,268942,197141,182817,14324,71801
-0.33256453,9.225571,2021,E09000023,Lewisham,300553,26927,80473,24253,154749,14151,242417,169579,155716,13863,72838
1.4246134,9.319961,2021,E09000024,Merton,215187,40019,22887,12765,129617,9899,172772,118900,112065,6835,53872
0.045572545,8.742481,2021,E09000025,Newham,351030,148187,61302,16419,107947,17175,276173,180739,163445,17294,95434
0.40564844,8.6659975,2021,E09000026,Redbridge,310261,146833,26096,12736,107974,16622,242020,152466,141630,10836,89554
2.577253,10.121722,2021,E09000027,Richmond upon Thames,195277,17467,3687,10662,157111,6350,155835,102821,97566,5255,53014
-0.40277874,9.144759,2021,E09000028,Southwark,307640,30540,77299,22151,158220,19430,256139,181218,166951,14267,74921
2.226796,9.92191,2021,E09000029,Sutton,209636,36787,12465,10162,143145,7077,165659,109810,104226,5584,55849
0.34409732,8.7007265,2021,E09000030,Tower Hamlets,310306,137856,22693,15409,122266,12082,252879,170536,155390,15146,82343
0.024097417,9.194924,2021,E09000031,Waltham Forest,278428,55545,41647,17983,147024,16229,222184,151835,140374,11461,70349
0.07960859,9.364525,2021,E09000032,Wandsworth,327506,38314,33062,20598,222090,13442,273559,201428,190441,10987,72131
0.9643086,9.051933,2021,E09000033,Westminster,204236,34242,16456,13335,112732,27471,177470,110288,101745,8543,67182
13.916409,9.125235,2021,W06000001,Isle of Anglesey,68879,430,104,598,67587,160,57148,30865,29203,1662,26283
8.775702,12.366526,2021,W06000002,Gwynedd,117392,1968,513,1333,112987,591,97968,54973,51817,3156,42995
9.0838375,12.394857,2021,W06000003,Conwy,114743,1651,271,1254,111176,391,96360,51587,48719,2868,44773
11.636729,11.185532,2021,W06000004,Denbighshire,95820,1650,268,1052,92488,362,78908,43036,40846,2190,35872
4.927618,12.399107,2021,W06000005,Flintshire,154960,1455,292,1446,151232,535,127578,77353,73820,3533,50225
7.0662107,12.433948,2021,W06000006,Wrexham,135122,2246,878,1558,129677,763,110274,65049,61805,3244,45225
13.644728,9.272749,2021,W06000008,Ceredigion,71473,1096,366,867,68776,368,61392,31964,30119,1845,29428
8.574136,12.432507,2021,W06000009,Pembrokeshire,123359,1159,244,1162,120375,419,102551,55534,52765,2769,47017
3.9599774,12.359071,2021,W06000010,Carmarthenshire,187898,2321,455,1756,182652,714,155487,85874,81952,3922,69613
1.2835605,11.539034,2021,W06000011,Swansea,238491,10451,2797,3808,218052,3383,197857,107375,100613,6762,90482
5.852038,12.627566,2021,W06000012,Neath Port Talbot,142290,2253,522,1583,137511,421,117182,62441,59191,3250,54741
5.8834715,12.687635,2021,W06000013,Bridgend,145490,2152,429,1684,140799,426,119482,67479,63984,3495,52003
7.4747896,11.861022,2021,W06000014,Vale of Glamorgan,131939,2807,624,2987,124800,721,107457,62959,59915,3044,44498
-0.11967197,10.089455,2021,W06000015,Cardiff,362310,34983,13896,14506,286931,11994,296314,172734,160440,12294,123580
1.4072489,11.605841,2021,W06000016,Rhondda Cynon Taff,237653,3506,997,2469,229923,758,193843,109606,103389,6217,84237
4.0324426,12.374526,2021,W06000018,Caerphilly,175955,1584,283,1754,171955,379,143484,81829,77439,4390,61655
13.854411,8.955057,2021,W06000019,Blaenau Gwent,66903,621,115,569,65456,142,55141,30651,28796,1855,24490
11.839632,10.966924,2021,W06000020,Torfaen,92276,1202,228,1005,89596,245,75112,42941,40654,2287,32171
11.981684,10.922665,2021,W06000021,Monmouthshire,92960,1185,230,1115,90106,324,78238,44558,42829,1729,33680
5.29263,10.840938,2021,W06000022,Newport,159592,12194,3737,4451,136473,2737,127420,77297,72787,4510,50123
7.0365725,12.438409,2021,W06000023,Powys,133169,1247,221,1135,130160,406,112536,64052,61726,2326,48484
14.448938,8.55153,2021,W06000024,Merthyr Tydfil,58839,871,91,510,57140,227,47676,27183,25634,1549,20493
